65-plusser|oudere
aai|aanhalen|streling|liefkozing
aaien|strelen
aak|binnenvaartschip
aal|paling
aanbellen|bellen|opbellen
aanbesteden|uitbesteden|uitbesteed
aanbevelenswaardig|raadzaam|verstandig
aanbeveling|getuigschrift|recommandatie|referentie|verwijzing
aanbiddelijk|enig|lief|schattig
aanbidder|liefhebber|vrijer|minnaar
aanbieden|overhandigen
aanblazen|distilleren|stoken
aanblik|aanzicht
aanboren|boren
aanbouw|balkon|uitbouw|erker|welving|luifel
aanbrengen|aangeven|klikken|uitbrengen|overbrengen|verraden|verklappen
aanbrenger|politie-informant|stoepier
aandacht|voetlicht
aandachtig|belangstellend|ge
aandelen|effecten|waardepapieren
aandelenbeurs|beurs|effectenbeurs|portemonnaie|studiebeurs
aandelenkoersen|koersen|zeeroutes
aandenken|gedachtenis|nagedachtenis|herinnering|souvenir
aandoening|beklacht|bezwaar|klacht|kwaal
aandoeningen|emoties
aandragen|aanvoeren|opperen|voorgaan
aandrift|instinct|intu|natuurdrift
aandriften|driften
aandrijven|aanjagen|aanmoedigen|instigeren|opkrikken|opwekken|stuwen|oppeppen|opwinden|voortstuwen|stimuleren|prikkelen
aandrijvingen|motoren
aaneengehecht|gekoppeld|on-line|verbonden
aaneenlassen|lasnaden|lassen|lasten
aaneenlasten|lasten
aaneenrijgen|dichtsnoeren|rijgen
aaneenschakelen|combineren|koppelen|samenvoegen|samenbinden|verbinden
aaneenschakeling|colonne|cyclus|gelid|serie|rij
aaneensluiten|klieken
aangapen|aanstaren|staren
aangeboren|ingeboren
aangebracht|ge
aangebrand|geprikkeld|ge
aangebroken|geopend|ontsloten
aangegeven|gedeclareerde|vermelde
aangehaald|geciteerd
aangeklaagde|beklaagde|beschuldigde|gedaagde
aangekleed|gekleed
aangekomen|gearriveerd
aangelegenheden|affaires|zaken
aangemeld|ingelogd|ingeschreven
aangenaam|fijn|goedaardig|lekker|plezierig|prettig
aangepast|aankunnen|aanpassen|gewendraken|aarden
aangeplant|geplant
aangerukt|gebracht
aangeven|declareren
aangevuld|aanvullen|aanvullende|completeren
aangezicht|front|voorgevel|voorzijde
aangezien|aldaar|daar|omdat|vermits|overmits
aangifte|getuigenis|mededeling|verklaring
aangrenzend|aanpalend|belendend|omliggend
aanhaken|aanhangen|aankoppelen|haken|tekenhaken
aanhalen|aanhaling|citeren|verscherpen|geknuffel|liefkozing|streling
aanhaling|citaat|liefkozing
aanhang|fans|supporters|volgers
aanhangen|aankoppelen
aanhanger|aanhangwagen|discipel|geestverwant|liefhebber|mandekker|getrouwe|volgeling|pleiter|supporter|volger|verdediger
aanhangers|fans|opleggers|supporters|sympatisanten
aanhankelijkheid|affectie|verknochtheid
aanhechten|nieten|voorplakken|vastnieten|voorzetten
aanheffen|inzetten|verwedden
aanhoren|beluisteren|luisteren|toehoren|gehoorzamen
aanhouden|doorzettingsvermogen|voortbestaan|taaiheid|voortduren|volharding
aanhouder|doordrammer|doorzetter|taaie
aanhouding|arrestatie
aanklacht|beschuldiging|tenlastelegging
aanklagen|betichten
aanklagers|beschuldigers
aankleding|decor|decoratie|versiering
aankloppen|aantikken|kloppen|tikken
aankomen|arriveren|bereiken|doordringen
aankomende|volgende
aankomst|komst|overkomst
aankondiger|aanwijzing|voorbode|voorloper
aankondiging|bekendmaking|bericht|boodschap|bulletin
aankoop|aankopen|acquisitie|afname|boodschap|koop|verkrijging|verwerving|aanschaffen|kocht|terugloop|mededeling|kopen
aankoopprijs|koopprijs
aankopen|aanschaffen|acquireren|verkregen|kocht|behaald|verwerven|kopen|verkrijgen
aankoper|cli|koper
aankunnen|aanpassen
aanleggen|aanmeren|meren|vastmeren|afmeren
aanlegplaats|aanlegsteiger|ankerplaats|steiger|ligplaats
aanleiding|beweegreden|oorzaak|reden|verontschuldiging
aanlengen|verdunnen|verwateren
aanlenging|verdunning
aanleren|bijbrengen|eigenmaken|doceren|leren|lesgeven|opsteken|onderwijzen
aanleveren|geeft|geleverd|toeleveren|leveren|levert
aanlokkelijk|aantrekkelijk|verleidelijk|uitnodigend
aanlokken|verlokken|weglokken
aanloop|bezoek|visite
aanmaken|bereiden|bereiding|toebereiding
aanmanen|manen|ontbieden|sommeren
aanmaning|aansporing|geheugenis|herinnering|oproep|herrinnering|roep|heugenis|uitdaging
aanmeldingsformulier|inschrijvingsformulier
aanmeldingskosten|inschrijfgeld|registratierecht|inschrijfkosten
aanmeren|vastmeren
aanmerkelijk|substantieel
aanmoedigen|aansporen|bemoedigen|manen|opbeuren|opporren|troosten|oproepen
aanname|stelling|these|thesis
aannemelijk|uitgang
aannemelijkheid|plausibiliteit|waarschijnlijkheid
aannemen|aanvaarden|adopteren|geloven|postuleren|veronderstellen|accepteren|adoptie|vooronderstellen
aannemer|bouwondernemer
aannemersbedrijf|bouwbedrijf
aanneming|adopteren|adoptie|confirmatie
aanpak|methode|werkwijze|werkmethode
aanpakken|beetgrijpen|vastpakken
aanpassen|afstemmen|bijstellen
aanpassing|bijstelling
aanplakbiljet|affiche|biljet|plakkaat|poster|reclamebiljet
aanplakker|plakker|sticker
aanprijzen|aanraden|adviseren|lopen|telefoon
aanpunten|punten
aanraden|adviseren
aanrakingspunt|raakvlak
aanranden|verkrachten
aanrander|aanvaller|overvaller|voorhoedespeler|voorspeler
aanrecht|gootsteen
aanreiken|geeft|schenkt
aanrekenen|verwijten
aanrijden|botsen|knallen
aanroepen|toeroepen
aanrotzooien|klungelen|knoeien|scharrelen|morsen
aanschaffen|acquireren|verkregen|verkrijgen
aanscherpen|intensiveren|toespitsen|verhevigen
aanscherping|verbetering
aanschouwen|aanstaren|bekijken|bespeuren|bewonderen|staren|observeren|zag|zie|zien
aanschroeven|dichtschroeven|vastschroeven
aanslaan|schatten|taxeren
aansluiten|bijdoen|bijvoegen|bijsluiten
aansluitend|naadloos
aansluiting|contact
aansluitingen|telefoonaansluitingen|telefoonlijnen
aansporend|hartversterkend|opwekkend|stimulerend
aansporing|houvast|hulp|steun
aanspraak|recht|rechtstitel|rechtsgrond
aansprakelijk|gehouden|toerekeningsvatbaar|verantwoordelijk
aansprakelijkheid|verantwoordelijkheid
aanstekelijk|besmettelijk
aanstellerij|podium|toneel|toneelpodium
aanstelling|benoeming
aanstippen|tippen
aansturing|haalbaarheid|koers|richting
aantal|tal|veel
aantasting|inbreuk|schending|schennis
aantekening|notitie
aantijging|beschuldiging|insinuatie|verdachtmaking|tenlastelegging|verdenking
aantikken|kloppen|tikken|typen
aantreden|toetreden
aantrekken|straktrekken
aanvaardbaar|acceptabel
aanvaarden|acceptatie|accepteren
aanval|uitval
aanvallen|attaqueren|attaques|bestormen
aanvaller|overvaller|voorhoedespeler
aanvang|begin|sart
aanvangstijd|starttijd|vertrektijd
aanvankelijk|eerst
aanvechten|bestrijden|betwisten|bevechten
aanvechting|temptatie|verleiding|verlokking
aanvoer|toevoer
aanvoeren|leiding|opperen|voorgaan|poneren
aanvoerster|leidster
aanvraag|petitie|verzoekschrift|rekest
aanvrager|rekwestrant|verzoeker
aanvullen|aanvullende|completeren
aanvuren|bejubelen|bezielen|toejuichen|stimuleren
aanwezig|afwezig|cadeau|dominant|present
aanwezigheid|bijzijn|presentie|tegenwoordigheid
aanwijzing|richtlijn|voorschrift
aanwijzingen|bijsluiter|gebruiksaanwijzing|gebruiksaanwijzingen|indicaties|instructies|handboek
aanzet|begin|initiatief
aanzetten|inschakelen|scherpen|slijpen|wetten
aanzien|exterieur|identiteit|prestige|image|status|zelf
aanzienlijk|royaal|vorstelijk
aanzoek|huwelijksaanzoek
aanzuiveren|nabetalen
aar|korenaar
aard|geaardheid|inborst|karakter|ziel|innerlijk|persoonlijkheid|wezen
aardappel|frites|patat|pieper
aardbei|ouderwets
aardboor|grondboor
aarde|aardkorst|bol|wereld|bodem|globe|grond
aarden|gewendraken
aardewerkproduct|keramiek|pottenbakkerskunst
aardgas|gas
aardig|leuk|lief|sympathiek
aardigheid|vriendelijkheid
aardigheidje|cadeau|presentje|verjaardagscadeau
aardkorst|akker|bodem|grond|onderbouwing
aardkunde|geologie
aardmannetje|gnoom|kabouter|kobold
aardrijkskunde|geografie
aardrijkskundig|geografisch
aardworm|pier|regenworm|worm
aartsrivaal|aartsvijand
aartsvijand|doodsvijand
aarzelen|dubben|talmen|twijfelen|weifelen|nasynchroniseren
aarzeling|twijfel|twijfeling
aas|lokmiddel
abattoir|slachterij|slachthuis
abc|alfabet
abdomen|buik|buikje|pens
abnormaal|uitzondering
abonnement|jaarkaart|seizoenkaart
abonnementsgeld|abonnementskosten
aborteren|afdrijven|stilhouden|stoppen
aborterend|afdrijvend
abortus|vruchtafdrijving|zwangerschapsonderbreking
abri|bushalte|bushokje|stopplaats
abrupt|bruusk|opeens|ineens|plotseling|plotsklaps
absentie|afwezigheid|nalatigheid|verzuim
absolutie|amnestie|kwijtschelding|begenadiging|pardon|sorry
absoluutheid|totaliteit|voltalligheid
absorberen|inspreken|opnemen|opslorpen
absorptie|opneming
abstinentie|onthouding
abstineren|bedanken|memoriseren|onthouden|danken|vasten|opnemen
absurd|belachelijk|bespottelijk|lachwekkend
absurditeit|dwaasheid|ongerijmdheid
academie|hogeschool|universiteit
academisch|theoretisch|universitair
accentueren|beklemtonen|belichten|benadrukken|ophelderen|verduidelijken
acceptatie|accepteren
acceptgiro|acceptgirokaart|overschrijvingsformulier
accijns|verbruiksbelasting
acclimatiseren|gewendraken|wennen
accordeon|trekharmonika
accountant|registeraccountant
accountantsverslag|verificatie
accu|accumulator|batterij
accuraat|nauwgezet|nauwkeurig|secuur
accuratesse|nauwgezetheid|nauwkeurigheid|precisie
achten|eerbiedigen|eren|lauweren|hoogachten|prijzen|respecteren|roemen|verheerlijken
achteraf|erna|naderhand
achterbak|koffer|kofferbak|kofferruimte
achterbaks|doortrapt|geniepig|snood
achterbuurt|armenwijk|krottenwijk
achterdocht|argwaan
achterdochtig|argwanend|wantrouwend|wantrouwig
achtereenvolgend|achtereenvolgens|opeenvolgend|successievelijk
achtereenvolgens|achterelkaar|successievelijk
achtergrond|afkomst|decor|oorzaak|toneel
achterhaald|afgedankt
achterhoofd|gedachten
achterkant|achterzijde|keerzijde|ommezijde
achterlaten|nalaten
achterliggen|achterliggende
achterlijf|onderlijf
achterlijkheid|kletskoek|waanzin
achternaam|familienaam
achteropraken|terugvallen
achterspeler|back|terug
achterstand|nadeel
achterstellen|discrimineren
achteruitgaan|terugdeinzen
achteruitgang|break-down|inzinking|verval|depressie|malaise
achtervolgen|schaduwen
achterwege|weg
achterwerk|billen
acroniem|example|letterwoord
acteren|toneelspelen
acteur|filmster|onderaannemer|uitvoerder
actie|aktie|daad|handeling
actiegroep|belangengroep
activa|baten|tegoed|bezit
activeren|opfrissen|stimuleren|opleven|verlevendigen
acuut|efemeer|kort|kortstondig
addenda|toevoegingen
addendum|additief|bijvoegsel|toevoeging|bijvoeging|toevoegsel
adel|adelstand|ridderstand|edelen
adelstand|edelen
adem|ademhaling|ademtocht|lucht|asem|zuurstof
ademen|ademhalen|inademen
ademhalen|inademen
ademhaling|ademtocht
ademstoot|verlangen|zucht|verzuchting
adept|ingewijd|insider
adequaat|effectief|ge
ader|bloedader|nerf
adjunct-directeur|adjunctdirecteur
administrateur|beheerder|boekhouder|intendant
administratie|boekhouding
administreren|beheren|besturen|leidinggeven|regeren
adolescent|jongere
adrem|gewiekst|scherpzinnig|snedig
adres|adressering
advertentie|annoncering
adverteren|promoten
advies|raad|raadgeving
adviesbureau|consultatiebureau
adviescommissie|stuurgroep
adviesprijs|richtprijs
adviesraad|raad|raadgeving
adviserend|raadgevend
adviseur|consulent|pleiter|raadgever|mode|raadsman
advocaat|jurist|pleitbezorger|pleiter|verdediger|voorstander
af|be|ge|over|uit|overheen|voltooid
afbeelden|portret|prent|scene|tafereel
afbeelding|plaatje|singeltje
afbetalen|vereffenen|verrekenen
afbetten|bespuiten|bevochtigen|deppen
afbinden|afsnoeren
afblaffen|snauwen|toesnauwen
afblazen|plassen
afbouw|afwerking
afbouwen|opheffen|voltooien
afbraak|sloop
afbreken|slopen|stoppen|stopzetten
afbreuk|beschadiging|nadeel|schade|overwonnen-worden|verlies
afdak|luifel
afdalen|landen|neerdalen|neerkomen
afdaling|daling|landing|terugloop|terechtkomen
afdanken|ecarteren
afdekken|afschermen|beschermen|blinderen|behoeden|beschutten|verdedigen
afdeling|autopsie|basisbestanddeel|bestuursregio|boomtak|departement|detachement|divisie|deelsoort|sectie|eenheid|ministerie|tak|gedeelte
afdelingen|departementen
afdelingschefs|afdelingshoofden
afdingen|afpingelen|dingen|gesjacher|marchanderen|spullen|handjeklap|onderhandelen|zaken
afdoend|beslissend|overtuigend|doorslaggevend
afdoening|afhandeling
afdraaien|afwenden|wegdraaien
afdragen|slijten|verslijten
afdrogen|drogen|droogmaken
afdruipen|druipen|druppelen|uitdruipen|uitlekken|druppen
afdrukken|drukken|knellen
afdrukmarge|kantlijn|marge|speling
affaires|spullen|zaken
affectie|verknochtheid
affiche|reclamebiljet
affirmatie|bekrachtiging|bevestiging|mededeling
afgebroken|gesloopt|vernield|weggebroken
afgedankte|gehandicapte
afgedempt|gedempt|halfluid
afgedicht|gedicht|vers
afgeladen|gevuld|vol|verzadigd
afgelegen|ver|veraf|verafgelegen
afgeleid|afkomstig|afstammend|geboortig|herkomstig
afgerond|gecompleteerd
afgeschreven|afgezien|overgeschreven
afgestudeerd|afstuderen
afgevaardigde|ambassadeur|gecommitteerde|gemachtigde|lasthebber|gezant|gedelegeerde|gevolmachtigde|gedeputeerde
afgeven|bevlekken|bezorgen|smetten|vlekken
afgezien|overgeschreven
afglijden|afzakken|wegzinken|vervallen
afgod|idool
afgraven|afgraving
afgrond|diepgang|diepte|perspectief
afgunst|jaloezie
afgunstig|jaloers
afhaken|stoppen
afhakken|afkappen|kappen
afhandeling|afwikkeling
afhangen|hangen|zweven
afhankelijk|horig|onderschikkend|onzelfstandig
afhankelijkheid|gewenning|knechtschap|verslaafdheid|verslaving
afhouden|beletten|pareren|reserveren|terughouden|tegenhouden|verdedigen|weerhouden|weren
afkeren|afwenden|wegdraaien
afkeuren|antoniem
afkeurend|afwijzend|verwerpen|weigerachtig
afkeuring|afwijzing|verwerping|weigering
afkijken|overschrijven|spieken
afklemmen|afknellen|afknijpen
afknellen|afknijpen
afkoelen|koelen|verkoelen
afkoeling|verkoeling
afkomst|afstamming|herkomst|komaf
afkondigen|bekendmaken|bevelen|decreteren|proclameren|verordenen|uitvaardigen|verordonneren
afkooksel|aftreksel
afkoop|afkopen|schadeloosstellen
afkopen|schadeloosstellen|terugbetalen
afkraken|katten|kritiseren|kraken
afladen|leegmaken|lossen|uitladen
afleiden|deduceren
afleiding|afleidingsmanoeuvre|distractie|verpozing|verzet|verzetje
afleren|ontwennen
aflevering|cessie|uitlevering|zending|overdracht
aflezen|lezen|oplezen|uitlezen
aflikken|gevangenissen|likken
afloop|eczeem|huiduitslag|puistjes|resultaat
aflopend|eindigend|glooiend
aflossing|aflossingsbedrag
afluisteren|luistervinken
afmaken|afronden|afslachten|afwerken|completeren|doden|afslachting|voltooien|perfectioneren|doodmaken|vermoorden|vervolledigen|doodslaan|ombrengen|mollen
afmatten|uitputten|vermoeien|verzwakken
afmattend|uitputtend|vermoeiend
afmatting|moeheid|uitputting|vermoeidheid
afmeren|vastmeren
afmeting|dimensie
afname|atavisme|daling|terugloop
afneembaar|demonteerbaar
afnemen|afzonderen|lichten|verwijderen
afnemend|slinkend
afnemer|cli
aforisme|motto|zinspreuk
afpalen|omlijnen
afpersen|chanteren
afpersing|chantage
afpingelen|marchanderen
afplukken|oogsten|plukken|verzamelen
afraden|ontraden
afranselen|afranseling|toetakelen|afrossen
afrastering|afscherming|begrenzing|omheining|limiet
afreageren|luchten
afreis|vertrek
afreizen|heengaan|vertrekken|opstappen|wegtrekken|weggaan
afrekenen|betalen|liquideren|ombrengen
africhten|africhting
afrijden|omlaagrijden
afrollen|ontrollen|uitrollen
afronden|voltooien
afronding|completering|voltooiing
afrukken|afscheuren|losrukken|onaneren
afschaffing|geheelonthouding|opheffing
afscheid|vertrek
afscheiding|beschot|hek|wondvocht|schot|hekwerk|tussenschot
afscheidingen|schotten|tussenschotten
afscheidscadeau|afscheidsgeschenk
afscheidsmaal|galgemaal
afschilferen|schilferen
afschrift|kopie|transcriptie
afschrijving|afwaardering
afschrikken|uitbannen|verjagen|wegdrijven
afschuiven|wegschuiven
afslachten|afslachting|slachtpartij
afslachting|bloedbad|moordpartij|slachtpartij
afsluitbomen|slagbomen
afsluitboom|slagboom
afsluitdijk|dam|dijk|keerdam
afsluitend|concluderend
afsluiter|slot
afsluiting|be
afsmijten|afwerpen
afsnijden|doorklieven|snijden
afspelen|weergeven
afspraak|akkoord|contract|regeling|overeenkomst|verbintenis
afstammeling|nakomeling|telg
afstammen|boomstammen|ontspruiten|ontstaan|spruiten|stammen|voortkomen|stekken|volksstammen
afstamming|herkomst|komaf
afstandelijkheid|gereserveerdheid|terughoudendheid
afstandsmaat|lengtemaat
afstelbaar|regelbaar|verstelbaar
afstelling|instelling|scherpstelling
afstemknop|regelaar
afstemmen|afwijzen|gelijkschakelen|terugwijzen|wegstemmen
afstemming|co
afstempelen|stempelen|stempeling
afstoffen|stoffen
afstomen|losweken
afstompen|vervlakken
afstotelijk|goor|onappetijtelijk|weerzinwekkend|walgelijk
afstoten|verwerpen
afstudeerrichting|studierichting
aftakking|driesprong|onderafdeling|splitsing|vertakking|wegkruising|zijtak
aftappen|biertappen|tappen
aftekenen|contrasteren
aftekening|autogram|tekening|dessin
aftrap|begin
aftreden|terugtrekken|uittreden
aftrek|afzwakking|vermindering|terugloop
aftrekken|distilleren|stoken
afvaardigen|delegeren|overdragen
afvaardiging|delegatie|missie|opdracht|roeping|taak
afvalbak|container|prullenbak
afvalhoop|belt|vuilnisbelt
afvallig|trouweloos|verraderlijk
afvallige|verzaker
afvalligheid|desertie|verlating
afvalmateriaal|afvalproduct|afvalstof
afvalmaterialen|afvalstoffen
afvalplaats|dump|stort|vuilstort
afvalproduct|afvalstof
afvalwater|rioolwater
afvloeien|wegvloeien
afvloeiing|drainering
afvoer|overbrenging|vervoer|transport
afvoerbuis|regenpijp|riolering|spui|riool
afvoerbuizen|riolen
afvragen|bevreemden|verwonderen|verbazen
afwachten|bewakers|wachten
afwasbaar|wasbaar
afwasmachine|vaatwasmachine|vaatwasser
afwaswater|sop|zee
afwatering|waterafvoer
afweerstoffen|antistoffen
afwegen|bepaalde|beschouwen|bepalen|inschatten|overdenken|overwegen|overpeinzen
afweren|beschermen|pareren|verdedigen|weren
afwezigheid|verstrooidheid
afwijking|gebrek|handicap|lichaamsgebrek
afwijzen|vertikken|weigeren
afwijzend|weigerachtig
afwijzing|verwerping
afwikkelen|zaakafwikkeling
afwisselen|amenderen|converteren|modificeren|inwisselen|veranderen|verwisselen|wijzigen
afwisselend|gevarieerd
afwisseling|keuze|variatie|verandering
afzakken|wegzinken
afzenden|opsturen|verzonden|wegsturen
afzender|verzender|zender
afzetgebied|afzetmarkt
afzetten|omranden|stilzetten|stoppen
afzoeken|zoeken
afzonderlijk|appart
afzuigen|opzuigen|wegzuigen
afzuigkap|wasemkap
afzwaaien|demobiliseren
afzwakken|uitputten|verflauwen|verslappen|verzwakken
afzwakking|vermindering
afzwenken|draaien|zwenken
agenda|notulen|zakagenda
agent|juut|smeris|tuut
agentschap|agentuur|bijkantoor|filiaal|vestiging
ageren|doen|handelen
agio's|
agitator|intrigant|stokebrand
airco|airconditioning|klimaatregeling
airmail|luchtpost
akelig|naar
aker|schepper
akker|grond|land|veld
akkerbouw|landbouw
akkerbouwgrond|landbouwgrond
akkoorden|overeenstemmingen
akte|overeenkomst
aktetas|tas
al|alhoewel|alreeds|hoewel|reeds|nu|ofschoon
alarm|hulpgeroep|noodsein|noodsignaal
alcohol|drank|wijngeest
alcoholmisbruik|drankmisbruik
alcolholadem|kegel
alcyon|ijsvogel
aldaar|daar|ginds
alert|attent|bedachtzaam|waakzaam|oplettend|omzichtig|voorzichtig|waaks
alge|welker|wier
algemeen|generaal
alhier|hier
alhoewel|hoewel|ofschoon
alias|schuilnaam|zogeheten|zogenaamd|zogenoemde
allebei|alletwee|beide|beiden
alleen|dolletjes|eenzaam|enig|enkel|ge|louter|schattig|exclusief|uitsluitend|inclusief
alleenheerser|heerser|monopolie|soeverein|majesteit
alleenstaand|single
alleenzang|solo
allemaal|allen|iedereen
allengs|gaandeweg|geleidelijk|langzamerhand|stapsgewijs|langzaamaan
alleraardigst|bekoorlijk|charmant
allerbeste|puikje
allerhande|allerlei
allerwegen|alom
allround|veelzijdig
almanak|jaarboek
alomtegenwoordig|alomvertegenwoordigd
alreeds|reeds
als|indien|mits
alsmaar|continue
alsmede|alsook|eveneens|evenzeer|evenzo|ook|evenals|honingdrank|tevens|mede|voorts|mee
alsof|nep
alstublieft|s.v.p.
alt|altstem
altijd|eeuwig|immer|steevast|immermeer
alvast|inmiddels|onderhand|intussen|odertussen|ondertussen|onderwijl
amalgamatie|fusie|samensmelting
amandelspijs|spijs|voeding
ambassadeur|gezant
ambitieus|eerzuchtig
ambrozijn|godenspijs|nectar
ambtelijk|formeel
ambtenaar|staatssecretaris
ambtsdrager|wethouder
ambtsgewaad|ornaat|toga
ambtsperiode|diensttijd
ambulance|ziekenauto|ziekenwagen
ambulant|trekkend
amendement|amendering|herziening|tegenwerping
amendering|herziening
ameublement|meubelen|meubels|meubilair
amicaal|vriendschappelijk
ammonia|ammoniak
ammunitie|munitie
amnesie|geheugenverlies
amnestie|kwijtschelding|vrijlating
ampelheid|uitgebreidheid|uitgestrektheid
amper|haast|rakelings|koud|nauwelijks|ternauwernood
Amsterdam|Mokum
amusement|vermaak|vertier|vermakelijkheid
amusementspark|pretpark
anaal|rectaal
analogie|contract|gelijksoortigheid|gelijkenis|gemeenschappelijkheid|overeenkomst
analoog|gelijkaardig|gelijksoortig|soortgelijk
analyse|analyseren|anatomiseren|ontleden|ontleding
analytisch|analytische
anamorfose|drogbeeld
anarchie|regeringsloosheid
anatomie|lichaam|lijf|organisatie
anatomiseren|ontleden
anders|verschillend
andersom|binnenstebuiten|omgekeerd|tegendeel|tegengesteld|tegenovergesteld|tegenstrijdig
anderzijds|daarentegen|daartegenover
anesthesist|narcotiseur
angel|gifangel|vishaak|weerhaak
angsthaas|bangerd|bangerik
angstig|bang|verschrikt|vreesachtig
angstvallig|zorgvuldig
animator|gangmaker|mentor|ziel
animo|interesse
anker|muuranker
ankerlip|blikje|lip|mond
ankerplaats|ligplaats
annalen|archief|gegevensbestand
annexeren|incorporeren|inlijven|overnemen
annuleren|annulering|nietigverklaring
annulering|nietigverklaring
anoniem|anonimiseren|naamloos
ansicht|ansichtkaart
antenne|voelspriet
anti|contra|tegen|tegenstrijdig
anticiperen|vooruitkijken
anticonceptie|geboortebeperking
anticonceptiemiddel|voorbehoedmiddel|voorbehoedsmiddel
antiekhandelaar|antiquair
antipool|tegenpool
antwoord|beantwoording|opbrengst|uitkomst|weerwoord|oplossing
antwoordapparaat|telefoonbeantwoorder
antwoorden|beantwoorden|ingaan|reageren|responderen
aorta|lichaamsslagader
apart|bijzonder|chic|exclusief|speciaal
apartement|appartement
apartheid|rassenscheiding
apparaat|toestel
apparaten|toestellen
appel|naamafroeping
appelbeignet|appelflap
appelkroontje|kroontje
appelmoes|moes|puree
applaudisseren|applaus|klappen|exploderen
applaudisseur|hoofdboek|klapper|knalbonbon
applaus|handgeklap|klappen
aquarel|waterverfschilderij
aquarelverf|waterverf
ar|limousine|slede|slee
arbeid|werk
arbeiden|functioneren|werken|werking
arbeidend|werkend|werkzaam
arbeiders|werklieden|werklui|werknemers
arbeidsbeurs|arbeidsbureau
arbeidscontract|arbeidsovereenkomst
arbeidsduurverkorting|arbeidstijdverkorting
arbeidskrachten|mankracht
arbeidsongeschikt|wao-er
arbeidsongeschikte|beperkt|gehandicapt|invalide
arbeidsovereenkomst|contract
arbeidstherapie|bezigheidstherapie
arbeidsveld|werkterrein
arbijdsduur|werktijden
arbiter|scheidsrechter
archief|gegevensbestand
architect|bouwmeester
architectuur|bouwkunde|bouwkunst
archiveren|bewaren|opbergen|deponeren|wegbergen|opslaan|wegsluiten
arena|kampplaats|strijdperk
argeloos|na
argeloosheid|onschuld
argumenten|beweegredenen|drijfveren|gronden|motieven
argumenteren|beredeneren|disputeren|redeneren|redetwisten|twisten
Aries|ram
aristocratisch|koninklijk
armenwijk|krottenwijk
armzalig|luizig
aroma|geur|geurstof|geurtje
arrangement|indeling|orkestratie|opstelling|rangschikking|regeling
arrangeren|groeperen|indelen|instrumenteren|orkestreren|ordenen|regelen
arrest|hechtenis
arrestant|gedetineerde|gevangene|veroordeelde
arresteren|gevangennemen|grijpen|inrekenen|oppakken
arriveren|kwam
arrogant|hoogmoedig|ijdel|kwasterig|neerbuigend|ingebeeld|verwaand|zelfingenomen
arrogantie|eigendunk|zelfingenomenheid|hoogmoed|hovaardij
arrondissement|departement|rechtsgebied|jurisdictie
arsenaal|wapenkamer
art|kunst
articulatie|mededeling|uitspraak|oordeelvelling
artieste|kunstenares
artiesten|kunstenaars
artikel|wetsartikel
artikelen|voorwerpen|waar|wetsartikelen
artistiek|doend|uitvoerend|uitvoerenmacht
arts|dokter|geneesheer|medicus
as|spil
asgrauw|grauw|vaal
asiel|dierenasiel|haven|opvangcentrum|vluchtelingenkamp|toevluchthaven|vrijplaats|toevluchtsoord
asielzoeker|refugi|vluchteling
asociaal|broekzak|buidel|hork|oen
aspect|facet|opzicht
assistent|bijstand|helper|hulp|hulpbetoon
assistentie|bijstand|dienstverlening|handreiking|hulp|hulpbetoon|medewerking
assisteren|helpen
assorti|gesorteerd
assuradeur|verzekeraar
assurantie|verzekering
astronaut|ruimtevaarder
astronomie|sterrenkunde
astronoom|sterrenkundige
atavisme|terugloop
atelier|studio|werkplaats
atol|koraaleiland
atoombom|kernbom
atoomwapen|kernwapen
attaqueren|bestormen|overkomen|overstelpen|overrompelen|overvallen
attenderen|verwijzen|wijzen
auctie|opbieding|veiling|verkoping
auditie|experiment|proef|test
auditorium|aula|gehoorzaal
aureool|halo|heiligenschijn|stralenkrans
auteur|dichter|maker|schrijfster|schrijver|schepper
auteurs|schrijvers
auteurschap|epistel|geschreven|pennen|schrijven
authentiek|oorspronkelijk
auto|automaat|wagen
autobus|bus|touringcar
autobussen|bussen
autochtoon|inboorling|inheems|inlander|inlands
autogarage|autostalling|garage|wagenschuur
autogordel|veiligheidsgordel
autogram|handtekening|ondertekening|tekening
automatisch|moeiteloos|vanzelf
automatiseren|computeriseren|geautomatiseerd
autonoom|onafhankelijk|zelfstandig
autoped|step
autopsie|sectie
autorijden|karren|rijden
autorijles|rijles
autorijschool|manege|rijschool
autorisatie|goedkeuring|machtiging|permissie|toestemming
autoriseren|fiatteren|inwilligen|laten|goedvinden|toekennen|permitteren|permissie|vergunnen|toelaten
autoriteit|deskundige|instantie|expert|kenner|specialist
autostalling|garage|wagenschuur
autostallingen|garages
autoverkeer|verkeer
autoweg|snelweg|verkeersweg
avance|toenadering
avant-garde|avantgarde
averij|schade
avonden|soirees
avonturen|durven|lotgevallen|riskeren|wagen
avonturier|gelukzoeker
axioma|grondbeginsel|grondstelling|hoofdstelling
azuren|azuur|hemelsblauw|azuursteen
azuur|azuursteen
B.T.W.|BTW|omzetbelasting
baai|inham
baal|bundel|pak|doos|herenkostuum|karton
baan|parcours|werk|werkkring|werkplek
baanbreker|pionier|voortrekker|wegbereider
baanvak|procesverloop|route|traject|weggedeelte
baar|cash|contant
baarmoeder|bovenbenen|schoot|moederschoot
baas|chef|leidinggevende
baat|gewin|profijt|marge|winst
babbeltje|gekeuvel|gepraat|gekwebbel|praatje
babbeltjes|geroddel|praatjes
baby|kind|kindje|zuigeling
babybox|box|opbergruimte
babysitter|kinderoppas|oppas
bacchanaal|drinkgelag|orgie|zwelgpartij|sexfeest
badjas|badmantel
badpak|zwempak
bagage|bepakking
bagagedrager|drager|kruier|sjouwer
bagatel|kleinigheid|wissewasje
bagatelliseren|vergoeilijken|vergoelijken
bagger|slijk|slik
baggerschip|baggerschuit
bajes|bak|strafgevangenis|doos
bak|kattebak|kattenbak
bakermat|geboorteland|geboorteplaats|oorsprong|thuisland|vaderland
bakken|gebakken|gevangenissen|likken
bakker|broodbakker
bakkerij|broodbakkerij|broodfabriek
bakpan|koekenpan|koekepan
baksteen|gesteente|steen|rolsteen
bal|basketbal|bol|dansfeest|gala|bolletje|galabal|bolstaand|bolvormig
balanceren|uitbalanceren|uitlijnen
baldadig|onnadenkend|roekeloos|vermetel
baldadigheid|kattekwaad|kattenkwaad
baldakijn|troonhemel
balg|blaasbalg
balie|counter|gerecht|rechtbank|toonbank
balken|dwarsbalken|leggers
balkonhek|balustrade|leuning|railing
ballen|bollen|kloten|opbollen|testikels
balletje|kogeltje
balling|banneling
ballingschap|verbanning
ballon|gedachtenwolkje|luchtballon
ballpoint|balpen|pen|pin|schrijfstift
balustrade|leuning|rugleuning
ban|geobsedeerd|kerkban|verbod
banaan|pisang
band|betrekking|plakband|liaison|tape|relatie|verhouding
bandana|das|halsdoek|shawl
banden|cassettebandjes|relatie
banderol|bies|strook|volant
bandiet|boosdoener|snoodaard|booswicht
banen|bevrijden|functies|emanciperen|vrijmaken
bang|ontsteld|schrikachtig|verschrikt|vreesachtig
banier|standaard|vaandel|vaan|vlag
banjeren|stampen|stampvoeten
bank|bankgebouw|canap|handelsbank
bankbiljetten|flappen
banken|handelsbanken|zandplaten|zitbanken
banket|feestmaal|galadiner
banketbakker|suikerbakkerij|taartenbakker
bankroet|failliet|faillissement
bannen|bezweren|uitbannen|uitstoten
banvloek|vervloeking|verwensing|vloek
bar|brochure|buffet|caf|folder|drankbuffet|tapkast
barbaar|onmens
barbaars|beestachtig|onmenselijk|bruut
barbecue|grill
barbecuen|grillen|roosteren
barbier|coiffeur|kapper
barmhartig|medelijdend
barmhartigheid|mededogen
barrageopstakels|hindernis|hinderpaal|obstakel
barricaderen|versperren
barricaderering|blokkade|versperring|wegversperring
barricadering|blokkade
bars|caf|kroegen
barsten|inscheuren|krakken|openspringen|scheuren
bas|contrabas
baseren|funderen|grondvesten|onderheien
basis|fundament|ondergrond|onderstel|poot|voet
basisbeginsel|fundament|grondbeginsel|grondbegrip|grondslag
basisbestanddeel|element|ingredi|factor
bassin|bekken|waterbekken|zwemwater
bast|schors
bastaard|hybride
baten|tegoed|voordelen
batig|positief
batons|dirigeerstokjes
bazen|chefs
bazig|overheersend
bazin|meesteres
bazuin|piston|trompet|toeter
beangstigen|beklemmen|benauwen
beantwoording|weerwoord
beat|ritme
bebloed|bloederig
bebossing|bosaanplant
bebost|boomrijk|bosrijk
beconcurreren|concurreren|wedijveren
bed|bedding|bloembed|bloemperk|leger
bedaardheid|geduld|gemak|kalmte|gemakkelijkheid|rust|kalmaan
bedacht|geprepareerd|voorbereid
bedankbrief|dankbetuiging|dankzegging
bedanken|bedankje|danken|erkentelijkheid
bedankje|danken
bedaren|bedwingen|beheersen
bedbank|slaapbank
beddendeken|bedekking|dek|deken
beddengoed|beddenlaken|lakens
beddenlaken|beddenlinnen|laken|linnen|lakens|linnengoed
beddenlinnen|linnen
beddensprei|sprei
bedding|rivierbedding
bede|eis|petitie|verzoek|interpellatie|rekest|vraag|smeekbede
bedeeld|geboren|geprezen|geschapen|gecre|gezegend
bedeesd|beschroomd|timide|schroomvallig
bedehuizen|gebedshuizen|kapellen|kerken|muziekgezelschappen
bedekken|bekleden|beslaan|maskeren|overtrekken|verbergen|verhullen
bedekking|dek|dekking
bedelen|begiftigen|schooien
bedelven|begraven|overstelpen|bestormen
bedenkelijk|donker|omstreden|onbetrouwbaar|verdacht
bedenken|beschouwen|fantaseren|overpeinzen|nadenken|uitdenken|verzinnen
bedenker|maker|ontwerper|uitvinder
bedenking|bezwaar|tegenwerping|verweer|verweerschrift
bedenktijd|onderbreking|respijt|uitstel
bederf|bederven|verrotten|verrotting
bederven|stukmaken|vergallen|verknoeien|verpesten
bedevaart|pelgrimage|pelgrimstocht
bedevaartganger|kruisvaarder|pelgrim
bediende|boerenknecht|gastvrouw|dienstknecht|kelnerin|knecht|ober|serveerster
bedienen|behoren|bijgieten|dienen|opdienen|serveren|helpen|voorzetten
bedoelen|intenderen
bedragen|geldsommen|zijn
bedreiging|dreigement
bedriegelijk|gefingeerd|onecht|onwaar
bedrieger|oplichter
bedrieglijk|misleidend
bedrijf|concern|handel|handelsbedrijf|onderneming|nering|winkelbedrijf
bedrijfsleven|koophandel|zakenleven|zakenwereld
bedrijfsrestaurant|kantine
bedrijfstak|beroepsgroep|branche
bedroefd|droevig|treurig|verdrietig
bedrukken|opdrukken
bedrukt|gedrukt|melancholisch|somber|treurig|triest
beduid|toegelicht|uiteengezet|uitgelegd|verduidelijkt
beduidend|enorm|gigantisch|ontiegelijk
beduvelen|besodemieteren
bedwelmd|bewusteloos
bedwelming|flauwte|katzwijm
bedwingen|beheersen|beteugelen
beekje|stroming
beeldbuis|buis|televisietoestel
beelden|beeldhouwwerken|plaatjes
beeldscherm|monitor
beeldspraak|metafoor
beeldverslag|reportage
been|bot
beenderen|botten
beer|fecali|mannetjesvarken|teddybeer
beerput|gierput
beest|dier
beestachtig|dierlijk|onmenselijk
beesten|dieren
beestenboel|bende|chaos|puinhoop|warboel
beestje|dier
beetgrijpen|vastklampen
beetje|ietsje
beetnemen|foppen|vastpakken
befaamdheid|beroemdheid
begaafd|getalenteerd|talentvol
begaan|plegen
begeerte|felicitatie|honger|hunkering|gelukwens|hoop|verlangen
begeleiden|loodsen|verwijderen|wegbrengen
begeleider|coach|instructeur|oefenmeester|trainer
begenadiging|kwijtschelding
begerend|smachtend|verlangend
begeven|flippen
begieten|besproeien|bespuiten
begin|start
beginletter|initiaal
beginletters|initialen|voorletters|parafering
beginneling|debutant
beginnen|opstarten|par
beginselverklaring|intentieverklaring
begluren|gluren
begraafplaats|kerkhof
begraven|overstelpen
begrensd|beperkt
begrenzing|grens|grenswaarde|limiet
begrijpelijk|inzichtelijk
begrijpelijkheid|duidelijkheid|helderheid|lichtsterkte
begrijpen|vatten
begrip|onbegrip
begripsbepaling|definitie
begroeting|groet|onthaal|saluut|groeten|ontvangst|handgebaar|welkom
begroten|berekenen|ramen|schatten
begroting|berekening|budget|prognose|schatting|taxatie
begunstigen|bevoordelen|voortrekken
beha|bustehouder
behaald|behalen|verkrijgen
behaard|harig|ongetemd|ruig|onherbergzaam
behalve|buiten|naast|tenzij|buitenshuis|exclusief|ongeacht|uitgezonderd|zonder
behandelen|verplegen|verzorgen
behandeling|treatment
behartiging|belangenbehartiging
beheer|management|toezicht|voogdij|zeggenschap
beheersen|beteugelen|intomen
beheersing|controle|zelfbeheersing
beheerst|ingetogen|rustig|teruggetrokken
beheksen|betoveren
behelzen|betekenen|inhouden
behendig|ingenieus|vaardig
behoeden|beschermen|bewaren
behoeftig|noodlijdend
behoren|behorend|toebehoren
behorend|toebehoren
behouden|beschermen|reserveren|bewaren|terughouden|conserveren|voorbehouden
behoudend|conservatief
behuizing|bewoning
behulpzaam|inschikkelijk|nuttig|meegaand
behulpzaamheid|dienstwilligheid
beieren|klokluiden|luiden
bejaarde|ouwe
bejaardenhuis|rusthuis|rustoord|verzorgingshuis
bejubelen|toejuichen
bek|mond
bekend|beroemd|vertrouwd
bekende|kennis|weten
bekennen|opbiechten
beker|bokaal|drinkbeker|cup|mok|pul
bekeuringen|bonnen|kassabonnen
bekken|heupgewricht|muilen|waterbekken
beklaagde|beschuldigde|gedaagde|verdachte
bekladden|besmeren|bevlekken|bevuilen|besmeuren|bezoedelen|smetten
beklagend|negatief|zeurderig|ontkennend
bekleding|stoffeerderij|stoffering
bekleed|gestoffeerd
beklemdheid|beklemming|benauwdheid
beklemmen|benauwen
beklemmend|benauwend|nijpend
beklemming|benauwdheid
beklemtonen|benadrukken
beklimming|bestijging|klim
bekomen|bijkomen
bekommerd|bezorgd|ongerust
bekoorlijk|fraai|mooi|prachtig|smaakvol
bekoorlijkheid|elegantie|goedertierenheid|gratie
bekrachtigen|certificeren|homologeren|ijkmerken|intensiveren|waarmerken|sterken|versterken
bekrachtiging|bevestiging|ratificering
bekritiseren|katten|kritiseren|pesten
bekrompen|benepen|kleingeestig|kleinzielig
bekrompenheid|geborneerdheid
bekruipen|besluipen
bekvechten|redetwisten|twisten
bekwaam|capabel
bekwaamheid|deskundigheid|professionaliteit
bekwamen|blokken|studeren|trainen
bel|hard|schel|hoog
belachelijk|bespottelijk
beladen|bevrachten|laden
belanden|geraken|landen|verzeilen|terechtkomen
belang|bij|gewichtigheid
belangeloos|onbaatzuchtig
belangrijk|bepalend|important|relevant|vitaal|beslissend|doorslaggevend|fundamenteel
belangstellend|ge
belast|bezwaard
belasten|bevelen|opdragen|verordonneren
belasteren|kwaadspreken|kwaadsprekerij|lasteren|roddel|zwartmaken
belastingdienst|fiscus
belastingen|heffingen
belastingtechnisch|fiscaal
belastingverlaging|lastenverlichting
belazeren|besodemieteren
beledigen|beschimpen|uitschelden|schelden
beleefd|netjes
beleefdheid|betamelijkheid|fatsoen|welgemanierdheid
beleg|belegering|broodbeleg
beleggen|investeren
belegger|investeerder
belegging|inlegkapitaal|investering
beleid|regelgeving
belemmeren|hinderen
belemmering|beletsel|obstakel|verhindering|hindernis
belendend|naburig|omliggend
belenen|verpanden|verpatsen
belening|verpanding
beletsel|obstakel
belettering|opdruk
belicht|bijgelicht|opgehelderd|uitgelegd|verhelderd|toegelicht|verlicht
belichten|verduidelijken
belijdenis|geloofsbelijdenis|vormsel
bellen|opbellen
beller|luider
belofte|gelofte|toezegging
beloofd|toegezegd
beloven|garanderen|toezeggen|verzekeren|waarborgen
belt|stortplaats|vuilnisbelt
beluisteren|luisteren
belust|gretig|happig
bemanning|crew
bemerken|signaleren|waarnemen
bemiddelen|tussenkomen
bemiddelingsbureau|interventiebureau
beminde|liefste|lieverd|schat|snoes
beminnaar|liefhebber|minnaar|vrijer
beminnen|houden|liefhebben|liefkozen|vrijen
bemoedigen|ondersteunen|opbeuren|troosten
bemoedigend|hartversterkend|opwekkend
bemoeien|mengen
bemoeienis|inmenging
benadeelde|gedupeerde
benaderen|toenaderen
benadering|benaderingswijze|invalshoek|optiek
benaderingswijze|optiek
benard|benauwd|penibel|precair
bende|rommel
benedenarm|onderarm|voorarm
benedenkaak|onderkaak
benen|poten
benepen|kleingeestig
bengel|boefje|kwajongen|deugniet
bengelen|gooien|slingeren|rondslingeren
benieuwd|nieuwsgierig
benjamin|jongste|laatstgeborene
benodigde|outillage|uitrusting|toerusting
benodigdheden|materialen
benodigdheid|bouwstof|materiaal|goedje|grondstof
benoembaar|verkiesbaar
benutten|bezigen|gebruiken|toepassen
benzine|brandstof|motorbrandstof
benzinepomp|pompstation|tankstation
benzinestation|tankstation
beoefenen|uitoefenen
beogen|pogen|proberen|trachten
beoogd|verbeeld|voorgenomen|voorgesteld
beoordeler|jury
beoordeling|inschatting
beoordelingscijfer|issue|punt
bepaalde|bepalen|defini|bepalend|determineren|vaststellen|voorschrijven
bepalen|defini
bepalend|defini
bepaling|voorwaarde
bepantseren|harnassen
bepantsering|harnas|pantser
beperkend|restrictief
beperking|restrictie
bepraten|bespreken|doorspreken
beproeven|probeer|proberen|uitproberen
beproeving|hulpbehoevendheid|temptatie|kwelling|verleiding|nood
beraad|overleg
beraadslagen|overleggen|overwegen
beraadslaging|bespreking|bijeenkomst|conferentie|overleg|manifestatie|samenkomst
beramen|berekenen|schatten|inschatten
berechten|doorgaan|vervolgen|voortzetten
beredeneren|redeneren
bereid|klaargemaakt
bereiden|brouwen|klaarmaken|toebereiden|toebereiding|voltooien
bereidheid|bereidwilligheid
bereiding|toebereiding
bereiken|doordringen|penetreren
berekenen|calculeren|uitrekenen|uitwerken
berekening|calculatie
berggeit|gems
berghok|berging|bergruimte|bewaarplaats
berging|bewaarplaats
bergkam|bergrug|kam|rug
bergkloven|kloven|spleten
bergrug|kam|rug|rugleuning
bericht|bewering|bulletin|mededeling|manifest|tijding|uitlating
berichtgeving|mededelingen
berispen|terechtwijzen|vermanen
berispinkjes|standjes
beroepsgroep|branche
beroerd|doodziek|slecht|kotsmisselijk
beroering|commotie|reuring
berouw|droefheid|spijt|inkeer|wroeging
beroving|roof|wondkorst
berrie|brancard|draagbaar
berustend|gelaten|lijdelijk|lijdzaam|voorbeeld
berusting|gelatenheid|lijdzaamheid
beschaamdheid|schaamte
beschadigen|schaden|verwonden
beschadiging|schade
beschaven|evolueren|kneden|ontwikkelen|maakt|vormen
bescheid|weerwoord
bescheiden|documenten|nederig|onbetekenend|papieren|onderdanig|triviaal|stukken|ootmoedig
bescheidenheid|nederigheid|onderdanigheid|pretentieloosheid
beschermd|beschut|risicoloos|veilig|zeker
beschermeling|prot
beschermheilige|patroon|schutspatroon
bescherming|dekking
beschieten|bestoken
beschieting|beschot|betimmering|lambrizering|paneel
beschijnen|lenigen|verlichten
beschikbaar|vacant
beschikbaarheid|beschikking
beschikken|voorschrijven
beschikking|besluit|boeteoplegging|dwangsom|vergunning
beschimmelen|schimmelen
beschimpen|bespotten|honen|uitschelden|verguizen
beschot|lambrisering|lambrizering|tussenschot
beschouwelijkheid|contemplatie
beschrijven|schetsen
beschrijving|defini|impressie|weergave
beschroomd|timide
beschroomdheid|g|schroom
beschuldiging|verdenking
beseffen|doorgrond|doorzien|inkijken|onderkennen|realiseren|doorhebben|inzien|verwerkelijken|verwezenlijken
beslag|deeg
beslagen|dof|glansloos|mat
beslissen|besluiten|raadsbesluiten
beslissend|doorslaggevend
beslissing|besluit
beslistheid|standvastigheid|vastberadenheid|zelfvertrouwen
besloten|priv
besluit|besluiten|conclusie|raadsbesluit|gevolgtrekking|slot|slotbeschouwing
besluiteloosheid|tweedracht|tweestrijd|twijfel
besmetting|infectie
besmeurd|bevuild|gevlekt
besnord|gekneveld
besodemieteren|misleiden
besparen|bezuinigen|korten
bespatten|bespetteren
bespieden|bespioneren|spioneren|verspieden
bespioneren|spioneren
bespoedigd|versneld
bespottelijk|grappig|lachwekkend
bespreken|doorspreken
bespreking|kritiek|recensie
besprekingen|vergaderingen
besprenkelen|sprenkelen
besproeien|bespuiten|bevochtigen|sproeien
bespuiten|sproeien
bessensap|jus|vruchtensap|sap
bestaan|bestaat|existentie|is|zijn
bestaanbaar|denkbaar|mogelijk|voorstelbaar
bestaansmiddel|levensonderhoud
bestand|partner
bestanden|computerbestanden
beste|liefste|uitgelezene|lieve
besteden|doorbrengen|spenderen|slijten|uitgeven
bestedingsvermogen|koopkracht
besteed|uitgegeven
bestek|couvert|eetgerei
bestel|samenstel
bestelauto|bestelwagen|camionette
bestellen|orderen|thuisbezorgen
bestemd|bestemmen
bestendig|betrouwbaar|degelijk|deugdelijk
bestendigheid|duurzaamheid
bestorming|run
bestrijden|bevechten
bestrijdingsmiddel|onkruidverdelgingsmiddel
bestseller|hit|succes|succesboek|succesnummer|welslagen
bestsellers|toppers
besturen|gezaghebben|leidinggeven|regeren
bestuurder|coureur|snelheidsduivel
bestuurders|chauffeurs|politici
bestuursregio|departement
betalen|financieren|vereffenen|voldoen|voldoet
betamelijk|welgevoeglijk|welvoeglijk
betekend|betekenen
betekenen|betekent|bezegelen|inhouden
betekenis|significatie|waarde
betekenisvol|veelbetekenend|veelzeggend
beter|huis
betogen|demonstreren
betoging|demonstratie
betonen|betuigen
betreden|bewandelen|binnengaan|binnentreden|binnenkomen
betreffen|betreft
betreffende|inzake
betrekkelijk|relatief
betreuren|spijten
betrouwbaar|degelijk|deugdelijk|probaat|solide
betrouwbaarheid|degelijkheid|geloofwaardigheid|deugdzaamheid|stevigheid
betweter|wijsneus
betweterig|dandy|pedant|schoolmeester
beugel|draagbeugel|stijgbeugel
beuk|beukenboom
beukehouten|beuken|rammen
beuken|bonken|rammen|stompen
beunhaas|prutser
beurs|buidel|effectenbeurs|knip|stipendium|geldbuidel|portefeuille|studiebeurs|portemonnaie|platvink
beurskrach|krach
beurswaarde|koerswaarde
beurt|onderhoudsbeurt|rondje|spelletje
beurtelings|omdebeurt
beuzelarij|futselarij
bevaren|varen|zeilen
bevat|bevatten|inhouden
beveiliging|bewaking
bevel|commando|order
bevelen|dicteren|gebieden|gelasten|verordonneren
bevelhebber|kapitein|scheepsgezagvoerder|schipper
bevelschrift|consigne|dwangbevel|lastbrief|mandaat|opdracht
beven|bibberen|rillen|schudden|sidderen|trillen
bevestigen|bevestiging|knevelen|vastmaken
bevestigend|conform|overeenstemmend|homoloog
beving|gebeef
bevlekken|bezoedelen
bevlekt|vlekkerig|vlekkig
bevloeien|irrigeren
bevoegd|gerechtigd
bevoegdheid|capabelheid|competentie
bevolen|opgedragen
bevolking|populatie
bevoordelen|voortrekken
bevoorrecht|geprivilegeerd
bevorderaar|promotor
bevorderen|promoveren|stimuleren
bevordering|promotie
bevrachten|inladen|laden
bevrachtingsovereenkomst|charter|chartervliegtuig|oorkonde
bevrediging|satisfactie|voldoening
bevreemden|verwonderen
bevreemding|verbazing|verwondering
bevrijd|gered|verlost
bevrijden|loslaten|vrijmaken
bevrijding|verlossing|vrijmaking
bevruchten|dekken
bevruchting|inseminatie
bevuild|gevlekt
bewaarder|conservator
bewaarkluis|brandkast|kluis|safe
bewaker|cipier|conci|portier|gevangenbewaarder|suppoost|wacht|zaalwachter
bewakers|wachten
bewapenen|wapenen
bewaren|conserveren|wegzetten|inleggen|instandhouden
beweegbaar|verplaatsbaar|vervoerbaar
beweeglijkheid|drukte|levendigheid
beweegreden|dessin|drijfveer|motief|motivatie
beweegredenen|dessins|drijfveren|motieven|stimuli
beweging|gebaar|lichaamsbeweging|verplaatsing|voortbeweging
bewegingloos|geduldig|lijdzaam
bewenen|rouwen
beweren|gesteld|pretenderen|stellen
bewering|uitspraak
bewerken|bewerkt|herschrijven
bewerking|herdruk
bewerkstelligen|realiseren|verwerkelijken|verwezenlijken
bewerkt|herschrijven
bewind|dieet|regime|staatsbestuur|staatsbestel
bewolking|wolken
bewonderaar|fan|supporter
bewoner|huisbewoner|inwoner
bezem|stoffer|veger
bezemen|vegen
bezeren|blesseren|verwonden|kwetsen
bezeten|fanatiek
bezetene|fanatieke
bezetten|innemen
bezichtigen|bezichtiging|bezien
bezield|enthousiast|geestdriftig|hardstochtelijk
bezigen|hanteren
bezinksel|droesem|residu|sediment|zetsel
bezinning|gewetensonderzoek|inkeer
bezit|bezitting|bezittingen|eigendom|heeft|have|tegoed
bezitten|hebben
bezitter|drager|eigenaar|houder|pennenhouder
bezittingen|eigendommen|have
bezoek|visite
bezoeken|opzoeken
bezoeker|museumbezoeker
bezoekers|gas
bezoekersaantal|opkomst
bezopen|dronken
bezorgd|ongerust|verontrust
bezorgdheid|verontrusting
bezorgers|koeriers
bezorging|postbezorging
bezuinigen|inkorten|korten|minderen
bezuiniging|kostenverlaging
bezwaar|repliek|verweer|verweerschrift
bezwaren|verzwaren
bezweren|uitbannen
bibberen|klappertanden|rillen
bibs|zitvlak
bidden|gebed|gesmeek|smeken|verzoeken
biechten|opbiechten
biefstuk|steak
bier|pils
bierbrouwerij|brouwerij
biertappen|tappen
bies|strook
bij|erbij|gedurende|honingbij|te|erop|onder|ter|tijdens|via
bijbehorend|bijgesloten|bijgevoegd
bijbenen|bijhouden
bijbetalen|bijleggen|meebetalen|verzoenen
bijdoen|bijsluiten|bijvoegen|insluiten|toevoegen
bijdragen|meebetalen|meehelpen
bijeen|gemeenschappelijk|gezamenlijk|samen|tezamen
bijeenbrengen|concentreren|samenbrengen|verzamelen
bijeenbrenging|compilatie|verzameling|opeenhoping
bijeengebracht|verzameld
bijeenkomst|congres|sessie|samanscholing|samenkomst
bijeenkomsten|samenkomsten
bijenhouder|imker
bijgaand|bijgesloten|bijgevoegd
bijgebouw|dependance
bijgelicht|uitgelegd|verlicht|verhelderd
bijgieten|doneren|inschenken|gieten|schenken|serveren
bijkantoor|filiaal
bijkeuken|pantry|spoelkeuken
bijl|hakbijl
bijleggen|meebetalen|schikken|toeleggen|verzoenen
bijna|haast|haastigheid|nagenoeg|zowat
bijschaven|perfectioneren|vervolledigen
bijschenken|bijvullen|vullen
bijscholing|nascholing
bijschrift|legenda|onderschrift
bijsluiten|insluiten|omsingelen
bijsluiter|gebruiksaanwijzing
bijsmaak|lust|nasmaak|smaak|smaakwaarneming
bijstaan|helpen
bijstand|bijstandsregeling|bijstandsuitkering|houvast|hulp|ondersteuning
bijster|bijzonder|kwijt
bijt|wak
bijtellen|optellen
bijtend|inbijtend|messcherp|schel|scherp
bijverdienste|schnabbel
bijvoeging|toevoeging
bijvullen|farceren|opvullen|vullen
bijwerking|neveneffect|nevenwerking
bijzetten|deponeren|neerzetten|geplaatst
bijzijn|tegenwoordigheid
bijzonder|bovenmatig|uitermate
bijzonderheden|bijzonderheid|details|finesse|kleinigheden
bijzonderheid|detail
bik|gruis|metselspecie|steengruis|mortel
bikkelhard|keihard|oorverdovend|steenhard
bikken|opeten|schransen|vreten
bilateraal|tweezijdig
binden|boeien|boekbinden|ketenen|knevelen|inbinden|knopen|strikken
binder|map|opbergmap|schrijfmap
bingo|kienspel
binnen|binnenshuis|hierbinnen|in|te
binnenbekleding|voedering|voering
binnenblazen|inblazen
binnendringen|binnenvallen|doordringen|indringen|penetratie|invallen|penetreren|infiltreren
binnengaan|binnentreden
binnengehaald|ingehaald
binnenkant|binnenzijde
binnenkomen|binnentreden
binnenkomst|entree|intrede
binnenkort|straks|weldra
binnenkrijgen|opslokken|zwelgen
binnenlands|nationaal|vaderlands
binnenlandse|nationale
binnenlopen|binnentreden
binnenstappen|binnentreden
binnenstebuiten|omgekeerd
binnentreden|ingaan|reageren
binnenvaren|invaren
biografie|levensgeschiedenis|levensloop
bioscoop|cinema|filmtheater
bips|kont
biscuit|biscuitje|koek|koekje
biscuitje|koek|koekje
bisdom|sticht
bistro|eetgelegenheid|restaurant
bits|kattig|onaardig|snauwerig|onvriendelijk|pinnig|onverdraagzaam|vinnig
bitterheid|wrangheid
bizar|raar|vreemd
blaaskaak|bluffer|opschepper|pocher|grootspreker|windbuil
blaaspijp|glasblazerspijp
blaat|blaten
bladen|magazines|tijdschriften
bladeren|doorbladeren
bladzijde|pagina
blaffen|brullen|bulderen|keffen|daveren|schreeuwen
blakend|fit|gezond|gezondheidsbevorderend
blanco|leeg|onbeschreven
blank|wit
blazen|fluiten|hijgen|pijpen|puffen
blazoen|wapenschild
bleekjes|pathologisch|ziekelijk
blende|blindering
blesseren|verwonden
blessure|kneuswond|letsel|kwetsuur
blij|blijmoedig|opgeruimd|opgewekt|vrolijk
blijde|opgewekt
blijdschap|vreugde
blijheid|opgewektheid|vrolijkheid
blijkbaar|blijkelijk|klaarblijkelijk
blijspel|klucht
blijvend|voorgoed
blik|conservenblik|oogopslag|opbergblik
blikje|busje|lip|opbergblik
blikken|lonken|oogopslagen|zien
bliksem|bliksemschicht|hemelvuur|flits
bliksemschicht|flits|flitslicht
blikveld|gezichtsveld
blind|vensterluik
blindelings|lukraak
blinkend|glimmend
bloedbad|slachtpartij
bloedgetuige|martelares
bloeding|bloeduitvloeiing
bloedplasma|plasma
bloedpomp|hart|rikketik
bloedschande|incest
bloedverwant|familielid|gezinslid
bloedziekte|hemofilie
bloeien|floreren|groeien|knallen|schieten|vuren
bloeiend|bontgekleurd|florissant|fleurig|kleurig
bloem|meel
bloembed|bloemperk
bloemenhandelaar|bloemist
bloemknop|knop|lichtknop|schakelaar
bloemstuk|boeket|ruiker
bloes|blouse
blok|hakblok|huizenblok|speelgoedblok
blokkade|wegversperring
blokken|hakblokken|studeren
blokkeren|stremmen
bloot|naakt|naaktfiguur
blootleggen|onthullen|ontmaskeren
blozen|gloeien|kleuren|nasmeulen|tinten|verven
bluffer|opschepper|pocher|windbuil
blusapparaat|brandblusser
blussen|doven|uitblussen
bluts|deuk
board|houtvezelplaat
bobbel|buil|bult|hobbel|uitstulping|zwelling|oneffenheid|knobbel|ongelijkheid
bobbelig|hobbelig|oneffen|ongelijkmatig
bochel|buil|bult|heuvel
bode|koerier|postbode|rondbrenger
boedel|erfenis|huisraad|inboedel|erfgoed|nalatenschap
boedelredder|curator|voogd
boefje|kwajongen
boefjes|deugnieten
boeg|voorsteven
boeien|fascineren|handboeien|ketenen|interesseren|intrigeren
boeiend|fascinerend
boek|pil|proza|roman
boekbespreking|recensie
boekbinden|inbinden
boekdrukkerij|drukkerij|krantendrukkerij
boekdrukkers|drukkers|plaatdrukkers
boeken|genoteerd|opschrijven|romans|reserveren
boekenlijst|literatuurlijst
boekentas|schooltas
boeket|ruiker
boekhandel|boekwinkel
boekhouder|intendant|kwartiermeester
boekomslag|enveloppe|kaft|kentering|omslag
boekvorm|gebonden
boekweit|weit
boekwerken|bundels|schoven
boenen|boenwerk|schrobben|schoonmaakwerk
boenwerk|schrobben
boer|oprisping
boerderij|hoeve
boeren|burpen|oprispingen|provincialen|oprispen
boerenknecht|knecht
boetiek|kledingwinkel|kledingzaak
boeven|schurken
boezem|borsten|riolering|tieten|riool
bof|oorspeekselklierontsteking
boffen|viezeriken|zwijnen
bofkont|geluksvogel
bok|mannetjesgeit
bokaal|cup
bol|bolletje|bolstaand|bolvormig|kogelrond|uitpuilend|rond
bollen|opbollen
bolstaand|uitpuilend
bom|explosief|granaat|projectiel|raketten|ontplofbaar
bombastisch|gezwollen|opgeblazen|pompeus|opgezwollen|overdreven
bon|prent
bonbon|chocolaatje|flikje
bond|unie
bondgenoot|geallieerde|geestverwant|medestander|gelijkgezinde|medestrijder|partner
bonken|dreunen|hameren|slaan|rammen
bonnen|kassabonnen
bons|pof
bont|bontgekleurd|fleurig|pels|kleurrijk|vacht|kleurig|veelkleurig
bontgekleurd|fleurig|florissant|kleurig
bonus|premie|toeslag|verzekeringspremie
bonzen|daveren|dreunen|denderen|luiden
boodschap|signaal|teken
boodschappen|inkopen|winkelen
boog|handboog|kruisboog|uitbouw|welving
booggewelf|gewelf|kelder|koepel
boogstreng|touw|touwtje
boomknoesten|knoesten|kwasten|kwibussen
boomrijk|bosrijk
boomstammen|stammen
boomstronk|stomp|stronk
boomtak|ent|tak
boomtakken|takken
boomwol|katoen|katoengaren|katoenstof
boon|sperzieboon
boor|boormachine|houtboor
boord|halskraag|scheepsdek|kraag
boordevol|volop
boordsel|passement
boos|laaiend
boosaardig|gevaarlijk|trouweloos|verraderlijk
boosdoener|snoodaard
boosheid|drift|woede|razernij|toorn
booswicht|snoodaard
bootwerker|havenarbeider
bord|eetbord|lichtreclame|schoolbord|reclamebord
borgmoer|spie
borrel|borreltje|neut
borrelen|borreluur|bruisen|drinken|wellen|zuipen
borstcrawl|borstslag
borstel|haarborstel|schuier
borstelig|stoppelig
borsten|tieten
borstharnas|kuras
borstkas|ribben|ribbenkast|thorax|tors
bos|bosland|bundel|gedichtenbundel|woud|gedichtenverzameling
bosje|bundel|heester|schoof|struik
bosjes|bundels|schoven|struikjes
bospad|tra
bossen|wouden
boten|schepen|vaartuigen
boterham|inkeping|snee|sneetje|snijwondje|snijwond|voor
botsen|knallen
bottleneck|knelpunt|verkeersknelpunt
bourgeois|burgerlijk
bout|moerbout
bouw|bouwsector|opbouw
bouwen|construeren|opbouw|opbouwen
bouwgrond|bouwterrein
bouwkunde|bouwkunst|bouwtechniek|constructietechniek
bouwmateriaal|bouwstoffen
bouwsels|constructies
bouwstof|grondstof|materiaal
bouwtechniek|constructietechniek
bouwval|ru
boven|bovenin|bovenop|daarboven
bovenal|vooral|voornamelijk
bovenbeen|dij
bovenbenen|schoot
bovendien|daarbij|daarenboven|ook
bovengenoemd|bovenstaand|voornoemd
bovenkant|bovenzijde
bovenleiding|rijdraad
bovennatuurlijk|metafysisch
bovenop|doodmoe|leeg|op
bovenstaand|voornoemd
bovenstaande|voorgaande
bovenste|opperste|voornaamst
boventallig|overcompleet
bovenzinnelijk|transcendent
box|opbergruimte
boxen|luidsprekers
braaf|gesuikerd|zoet|zoetsmakend
braaksel|kots
braam|braambes
brabbelen|krompraten
brak|zout
braken|gespuug|kotsen|spugen|spuwen
brancard|draagbaar|goedzittend
brandbaar|ontvlambaar
branden|brandmerken|verzengen|inbranden|zengen|markeren
brandend|heet|vlammend|warm
brander|gasbrander|schrijver|gasstel
brandhaard|haardstede|vuurhaard
brandkast|kluis
brandkasten|kluizen
brandmerken|inbranden|markeren
brandpunt|focus
brandstof|motorbrandstof
brandstoffen|motorbrandstoffen
brandveilig|brandvrij|onbrandbaar
brandvrij|onbrandbaar
brandweerauto|brandweerwagen
brassen|schransen|slempen|vreten
break|pauze
breed|breedgeschouderd|veelzijdig
breekbaarheid|broosheid
breekhamer|moker|voorhamer
breekijzer|koevoet
breker|golf|roller
breuken|legger|teller
brevet|licentie|mandaat|vergunning
brief|epistel|geschreven|schrijven
briefomslag|couverture|envelop|enveloppe|omslag|wikkel
briefwisseling|correspondentie
bries|scheet|wind|stormwind
briljant|slim
brille|glans
brilmontuur|montuur
brochure|folder|pamflet|vlugschrift
broddelwerk|knutselarij|knutselwerk
broed|broedsel|kinderen|nageslacht|kroost
broeden|uitbroeden
broeder|diaken|lekenbroeder|hulp|verpleger
broeders|broers|kloosterlingen
broeikas|plantenkas
broek|pantalon
broeksgulp|gulp
broekzak|zak
broers|gebroeders
brok|klont|klonter
brokken|stukken
brombeer|grompot
bromfiets|brommer
brommen|gonzen|zoemen
bron|informatiebron|inspiratiebron|put|rivierbron|waterbron|waterput|wel
bronchie|luchtpijp|trachea
bronstig|krols|loops
bronwater|mineraalwater|spawater
bronzen|bruinen
broodje|kadetje|puntje
broodwinner|kostwinner
broodwinning|kostwinning
brouwen|toebereiden
brouwsel|melange|mengsel
brug|compositie|kunstwerk
bruidsdagen|wittebroodsweken
bruikbaar|goedkoop|praktisch|werkbaar|voordelig|winstgevend
bruikbaarheid|inpasbaarheid|relevantie
bruikleen|leen
bruiloft|bruiloftsfeest|huwelijk|huwelijksinzegening|trouwerij
bruiloftsfeest|huwelijksfeest|trouwerij
brullen|gillen|grienen|roepen|janken|huilen|schreeuwen|krijsen
brutaal|onbeschroomd|vrijpostig
brutaalweg|doodleuk
bruut|onmenselijk
bubbelbad|jacuzzi
buffel|karbouw
buffet|buffetkast|dressoir|tapkast
buffetkast|dressoir|porseleinkast
bui|gemoedsgesteldheid|gril|humeur|regenbui|gemoedstoestand|kuur|nuk|stemming
buidel|hoop|portemonnee|stapel|zak|tas
buidels|buidelzakken|portemonnees
buigen|krombuigen|krommen|kromtrekken
buiging|nijging
buigzaamheid|flexibiliteit
buik|buikje|pens|voormaag
buikje|fles|langhals|pijpje|platvink
buikkramp|buikpijn
buikloop|diarree
buil|knobbel|knoest|talent
builenpest|pest|plaag
buis|televisie|televisietoestel
buit|onderschepping|vangst
buiten|buitenshuis|zonder
buitenhuis|buitenverblijf|landhuis
buitenkans|mazzel|meevaller|voordeel
buitenkant|buitenzijde|huls|omhulsel|uiterlijk
buitenlander|onbekende|vreemdeling
buitenlanders|onbekenden|vreemdelingen
buitenlands|uitlandig
buitenleven|landleven|plattelandsleven
buitenlucht|geur|lucht|openlucht|zuurstof
buitenmuren|buitenwanden
buitensluiten|diskwalificeren|uitsluiten
buitensporigheid|uitwas
buitenstaander|outsider
bul|universiteitsdiploma
bulderen|daveren|denderen|dreunen
bult|heuvel|kneuswond|terp|kneuzing|letsel
bumper|stootrand
bundel|gedichtenbundel|gedichtenverzameling
bureau|bureaumeubel|lessenaar|kantoor|schrijftafel
bureaustoel|kantoorstoel
buren|omwonenden
burger|onderdaan
burgers|commune|gemeenschap|landbewoners
burgerschap|staatsburgerschap
burpen|oprispen
bushalte|bushokje|halte|stopplaats
businesspartner|zakenpartner
butler|kamerdienaar
butsen|indeuken|kaatsen
buurten|praten|wijken
cabaret|kleinkunst|kleinkunsttheater
cabaretartiest|cabaretier|komiek
cabaretier|grappenmaker|komiek
cabine|cockpit|hut|kamertje|kleedcabine|telefooncel|kajuit
cadans|ritme
cadeau|geschenk
cadeautje|geschenk|presentje
cafetaria|frituur|snackbar|frituurpan|patatkraam
cahier|schrift
calculator|rekenmachine|zakjapanner
calculeren|uitrekenen
calvinistisch|gereformeerd
cameraman|filmer
campagne|strijd
camper|kampeerauto
camping|kampeerplaats|kampeerterrein
campingplek|kampeerplaats
cannabis|marihuana
capabelheid|competentie
capaciteit|inhoud|kapitaal|kracht|vermogen
capillair|haarbuisje|haarvat
capitulatie|overgave|passie|toewijding
capituleren|opgeven|uitleveren|overgeven
carbon|doorslag
carcinoom|kankergezwel
cardioloog|hartspecialist
cargadoor|scheepsagent
carnivoor|vleeseter
casco|cascowoning|scheepsromp|vliegtuigromp
cash|contant|metselspecie|specie
casino|gokhal
cassette|cassettebandje
cast|personages
catalogiseren|indelen|ordenen|organiseren|schikken|regelen
catarre|darmontsteking
catastrofe|drama|onheil|ramp|onheilsdreiging|toneelstuk|tragedie
catastrofes|rampen
cel|kluizenaarshut
celdeling|deling
celebreren|feesten|feestvieren|ontspannen|vieren
cello|violoncel
cellulose|plantecelwandstof
cement|cementlaag
centen|geldstukken
centimeter|meetlint
centrale|hoofdbureau|krachtinstallatie|meldkamer|schakelbord
centrumspits|kien|spits|puntig
cerebraal|verstandelijk
ceremonie|plechtigheid
certificaat|charter|oorkonde|diploma
cessie|overdracht
champignon|paddestoel|paddestoelsoort|zwam
chaos|puinhoop
chaotisch|ongeregeld|rommelig
chapiter|hoofdstuk|kapittel
chargeren|overdrijven
charisma|radiatie|uitstraling
charlatan|kwakzalver
charter|chartervliegtuig
charteren|huren
chartervlucht|lijnvlucht|ontsnapping|uitbraak|vliegtocht
chef-kok|chefkok
cheffin|verkoopster|winkelbediende|verkoper
chemicus|scheikundige
chemie|scheikunde
chemisch|scheikundig
chic|keurig|net|netjes
Chinees|spleetoog
chirurgisch|operatief|werkklaar
chocolaatje|flikje
chocolade|chocoladereep|reep
chocoladereep|reep
Christus|Jezus|Jezus Christus|Messias
cijferlijst|schoolrapport
cilindervormig|cilindrisch
cipier|gevangenbewaarder
circa|omstreeks|ongeveer|pakweg
circulaire|mailing|nieuwsbrief|rondschrijven
circulatie|omloop|roulatie|rouleren
circuleren|roulatie|rouleren
cirkel|cirkelvorm|ringetje|kring|ronde|rondje
cirkelvorm|kring
claim|eis|keuze|rechtsvordering|optie|voorwaarde|voorkeur|voorkoop
classificeren|rangordenen|rangschikken
clavecimbel|klavecimbel
claxon|toeter|trompet
claxonneren|toeteren
clementie|compassie|goedgunstigheid|welwillendheid|goedwillendheid
clitoris|kietelaar|kittelaar
closet|plee|toilet|wc
clown|harlekijn
clubbestuur|verenigingsbestuur
coachen|trainen
coalitie|samenwerking
coderen|codering
cognitie|kennis
coherent|samenhangend
coiffeur|kapper
colbert|jasje|jekker
collecte|inzameling
college|collegium
collegejaar|studiejaar
colonne|dossier|file|rij|verkeersopstopping
column|katern
combineren|samenvoegen
comedo|mee-eter
commandant|luitenant-kolonel|overste
commentator|correspondent|verslaggever|journalist|reporter
commercie|goederenhandel|handel|handeldrijven
commercieel|kapitalistisch
commissaris|hoofdcommissaris
commissie|makelaarsprovisie|provisie
commode|ladekast|ladenkast
commotie|ophef
communicatiemiddelen|media
communiceren|klikken|overbrengen|vertalen
compact|klein
compagnies|gevechtstroepen|troepen|manschappen
compartiment|coup
compatibel|verenigbaar
compensatie|subsidie|tegemoetkoming
competitie|wedstrijd
compilatie|verzameling
compleetheid|volledigheid|voltalligheid
completering|volbrenging|voltooiing
complex|ingewikkeld
complicatie|hersenbreker|probleem|kwestie
compliment|mooipraterij|vleierij
complot|samenzwering
componist|toonkunstenaar
compositie|intonatie|mars|stembuiging|wandeling
composities|samenstellingen|toonzettingen
compost|teelaarde
comprimeren|samenpersen
compromis|regeling|vergelijk
computer|laptop|pc|rekentuig
computeriseren|geautomatiseerd
computerkunde|informatica
computertoets|proefwerk|toets
concentratie|dichtheid
concentreren|focussen|samenbrengen
concert|muziekstuk
conclusie|gevolgtrekking|slotbeschouwing|slotsom
conclusies|gevolgtrekkingen|slotbeschouwingen
concreet|tastbaar
concurrent|mededinger
concurrentie|mededingers|rivaliteit
conditie|vorm
condities|voorwaarden
conditionering|dressuur|les|opleiding
condoleance|condoleantie|rouwbeklag|deelname
condoleantie|rouwbeklag
conducteur|tramconducteur
confectie|confectie-industrie|confectiekleding
confidentieel|intiem|vertrouwelijk
confiscatie|inbeslagneming
conform|overeenkomstig|overeenstemmend
consensus|overeenstemming
consequentie|gevolg
conserveerbaar|houdbaar|verdedigbaar
conserveerbaarheid|houdbaarheid
conserveren|inleggen|instandhouden
consideratie|toegeeflijkheid
consigne|dwangbevel|wachtwoord|lastgeving|opdracht
consolidatie|verharding|versteviging|versterking
constant|onveranderlijk
constateren|geconstateerd|vaststellen
constatering|vaststelling
constipatie|opstopping|verstopping
constitutioneel|grondwettelijk|staatsrechtelijk
constructie|fabricage|opbouw
consult|consultatie|raadpleging
consulteren|raadplegen
consumeren|gebruiken|nuttigen|verbruiken|nemen|verdisconteren|verwerk|verwerken
consumptie|verbruik
consumptie-ijs|ijsje|roomijs
consumptiegoed|verbruiksartikel
consumptieijsjes|ijsjes
consumpties|spijsverteringen|verteringen
contact|voeling
contactdoos|stopcontact|wandcontactdoos
contactlens|lens
context|setting
contingent|quota|quotum
continu|doorlopend|non-stop|onafgebroken|voortdurend
contour|omlijning|omtrek
contra|tegen|versus
contracteren|opschrijven|samentrekken|vastkluisteren|vastleggen|verschrompelen
contrast|tegenstelling
contrasterend|strijdig|tegenstrijdig
controlepost|doorlaatpost
controleren|nakijken|narekenen|natellen
controleur|inspecteur
conventie|gebruik
conversie|omzetting
converteren|omzetten|verwisselen
corporatie|handelsmaatschappij
correct|juist|keurig|onberispelijk
correctheid|juistheid
correctie|herstelling|rectificatie|verbetering|reparatie|vervanging
corrector|verbeteraar
correspondent|verslaggever
corridor|doorgang|gang|gangpad|passage|snelheid
corrumperen|omkopen
corrupt|omkoopbaar
corruptie|omkoping
coryfee|geweldenaar|kei|rolsteen|slimmerd
cosmetica|cosmetica-industrie|grime|layout|visagie|make-up|schmink|opmaak
counter|tegenstoot|toonbank
coup|staatsgreep
couvert|eetgerei|maaltijdgang|enveloppe
couverts|enveloppen
cover|voorkant
creatuur|schepsel
creche|peuterspeelzaal
creditnota|kredietnota
cremeren|verassen|verbranden
crimineel|delinquent|misdadiger
crisis|depressie|keerpunt|laagconjunctuur
criterium|vereiste|voorwaarde
criticus|recensent
crucifix|kruisbeeld
curator|gezinsvoogd|voogd
cureren|genezen|hersteld
cursus|opleiding|vorming
cv-ketel|verwarmingsketel
cycloon|tornado|wervelstorm|wervelwind
cyclus|tijdkring
cypergras|zegge
daadkracht|momentum|puf|vlijt|werklust
daadwerkelijk|echt|feitelijk|heus|waarlijk|metterdaad|werkelijk
daar|daarginds|daarheen|ginder|ginds
daarbinnen|daarin|erin
daarbovenop|en|plus
daarginds|ginds
daarin|erin
daarmee|ermee
daaronder|eronder
daarover|daarvan
daartussen|tussenin
daas|dof|versuft|mat
dacht|denk|denken
dagboek|journaal|nieuws|nieuwsjournaal
dageraad|morgenschemering|ochtendgloren|ochtendstond|zonsopgang
daglicht|zonlicht
dagretour|retourtje
dagtekenen|dateren|teruggrijpen
dagtekening|datum
dak|kap|koepel|nok|overkapping
dakbinten|spanten
dakdekken|dekken
daken|huisbedekkingen
dakgoot|goot
dakkamertje|zolderkamertje
daklicht|dakraam|dakvenster
dakraam|dakvenster
dakspant|spant
dalen|valleien
dam|dijk|keerdam|stuw|stuwdam
dame|lady
damesondergoed|lingerie
damestas|handtas|tas|tasje|zak
damesverband|maandverband
dametje|vrouwtje
damp|rook|stoom|walm
dampen|stomen|uitwasemen|verdampen
damschijf|discus|schijf|diskette|grammofoon|moot
dandy|fat|knoest|kwast|pedant|kwibus
dank|harmonie
dankbaar|erkentelijk
dankbaarheid|danken|erkentelijkheid
dankbetuiging|dankzegging
dapper|frank|heldhaftig|kloek|kloekmoedig|moedig|koen|manhaftig
dapperheid|moed
darm|darmen|ingewanden
darmen|ingewanden
dartel|speels
dartelen|huppelen
das|halsdoek|stropdas
dashboard|instrumentenbord
data|gegevens
databank|database|databestand
dateren|teruggaan|teruggrijpen
daveren|denderen|dreunen
daverend|donderend
de|den
deal|overeenkomst
debacle|ineenstorting|instorting|ondergang|neervallen|teloorgang|val
debatteren|discussi
debiel|dement|flapdrol|mafkees|idioot|gek|zwakzinnig
debuut|opwachting
decennium|tienjaarsperiode
decent|gepast|welgevoeglijk|ge|welvoeglijk
dechiffreren|decoderen|ontcijferen
decimaal|tientallig
declinatie|verbuiging
declineren|vertikken|weigeren
decor|toneeldecor|versiering
decreteren|uitvaardigen
deel|eindje|fragment|onderdeel|percentage|portie|sector|stukje
deelbaar|verdeelbaar
deelname|deelneming|participatie|rouwbeklag
deelnemen|meedoen|participeren|meespelen
deelnemer|participant
deels|gedeeltelijk|ten dele
deelsoort|tak
deeltje|onderdeeltje
defensief|verdedigend
definitief|permanent|voorgoed
degelijk|solide|stevig
degelijkheid|deugdzaamheid|forsheid|hechtheid|stevigheid
degene|diegene
degradatie|ontering|verlaging
deinen|golven
deining|ophef|schommeling|zeegang
dekken|overkappen|overwelven
dekmantel|fa|uiterlijk|voorkomt
dekschild|schild
dekschilden|schilden
delegeren|overdragen
delen|porties
deler|gever
delfstof|erts
delicatesse|lekkernij|versnapering
delict|misdaad|misdrijf
delinquent|misdadiger
delven|graven|opgraven
delver|graver
dement|zwakzinnig
demontage|ontmanteling
demonteren|ontmantelen
demper|geluiddemper|klankdemper
den|dennenboom|greneboom
denigreren|kleineren
denk|denken
denkbaar|eventueel|voorstelbaar|mogelijk|wellicht
denkbeeldig|ide
denkers|filosofen
denkoefening|gedachtenoefening
denktrant|denkwijze
denkwerk|hoofdarbeid
denkwijze|geest|geesteshouding|gezindheid|houding
dennenboom|greneboom|sparreboom
departement|ministerie
deponeren|inleggen|leggen|storten|neerzetten|stortregenen|zetten
deportatie|deporteren|uitzetten|uitbannen
deporteren|uitzetten
depressie|laagconjunctuur|lagedrukgebied
dergelijk|dergelijke|zulk|dusdanig
dergelijke|zulke
dermate|zo'n
dermatoloog|huidarts
desertie|verlating
design|vormgeving
desinfecteren|ontsmetten
desintegreren|uiteenvallen
deskundige|expert|kenner
deskundigheid|professionaliteit
desondanks|doch|niettemin|evenwel|toch
desserts|toetjes
dessin|motief|patroon|tekening
dessins|motieven
destructief|vernietigend|verwoestend
detailhandel|kleinhandel
detective|detectiveroman|rechercheur|speurhond|speurder
detente|dooi|dooiweer
detineren|houden|vasthouden
deugdelijk|probaat
deugniet|jongen|kwajongen|rotzak|rakker|stinkerd
deun|geleerd|wijs|gestudeerd
deuntje|wijsje
deurklink|deurkruk|handgreep|klink|hendel|klungel|kruk
deurknip|knip|knipsluiting|portemonnaie
deurkrukken|krukken
deurwaarder|gerechtsdeurwaarder
deurwaardersexploot|kennisgeving|sommatie
devies|kenspreuk|leus|lijfspreuk|wapenkreet|motto|zinspreuk
dextrose|glucose
deze|dit
diabetes|suikerziekte
diafragma|lensopening
diagonaal|hoeklijn
diaken|verpleger
dialect|flinterdun
dialoog|samenspraak
diameter|middellijn
dicht|sluit
dichtbijten|happen|toebijten
dichtdoen|dichtknopen|toedoen|toetrekken
dichter|po
dichterbij|nader|naderbij
dichtgespen|dichtsnoeren|rijgen
dichtkunst|dichtwerk|po|lyriek
dichtschroeven|vastschroeven
dichtwerk|po
dicteren|gelasten|inboezemen|ingeven|influisteren
dictionaire|vertaalwoordenboek|woordenboek
didactiek|onderwijskunde
didactisch|onderwijskundig
die|diegene
Diederik|Dirk
dieet|di|lijnen|vermageringskuur|regime
dief|geveltoerist|rover|inbreker|struikrover
diefstal|inbraak|roof
dienaar|dienstknecht|knecht
dienst|engageren|voorkomendheid
dienstbaarheid|dienstvaardigheid
dienstbode|dienstmeisje
dienstboden|dienstbodes|meiden
dienstbodes|meiden
diensten|instituten|kerkdiensten|services
dienstvoorschrift|reglement|voorschrift
dientengevolge|zo|zodoende
diep|diepgevoeld|diepliggend|diepzinnig|innig|intens
diepgang|holte|waterverplaatsing
diepgevoeld|innig
diepvrieskist|diepvriezer|vriezer
dierbaar|lievelings
dierenarts|veearts
dierenrijk|fauna
dierentemmer|dresseren|dressuur|paardendresseur
dierenverblijfplaats|hok|hutje
dierenverzorger|dierverzorger|verzorger
diesel|dieselmotor|dieselolie|dieseltrein
dieseltrein|goederentrein|hakkepuf|locomotief|spoortrein
diftong|tweeklank
dijkgraaf|schout|schoutendiender
dikkerd|dikzak|vetzak
dikte|lijvigheid|zwelling
dikwijls|herhaaldelijk|veelvuldig
dikzak|vetzak
diner|maaltijd
dineren|tafelen
dingen|goedje|spullen|waar
dingetjes|futiliteiten
diploma|oorkonde
direct|meteen|ongezouten|rechtstreeks|onmiddellijk
directeurschap|directoraat
directieteam|managementteam
dis|eettafel
discipel|volgeling
discipelen|volgelingen
disco|discotheek
discretie|geheimhouding
diskwalificatie|royement|uitsluiting
diskwalificeren|royeren|uitsluiten
dispensatie|ontheffing|vrijstelling
disputeren|redetwisten
dissertatie|proefschrift
distilleerder|stokebrand|stoker|tweedrachtzaaier
distribiteur|distributeur|verdeler|verspreider
distribueren|rantsoeneren|ronddelen|rondgeven|uitreiken|verdeel|verdelen|uitdelen|verkavelen
distributie|distributiekantoor|rantsoenering|verdeling|verspreiding
dithyrambisch|vurig
dito|evenzo|ook
divers|verscheiden
dobbelsteen|teerling
docent|instructeur|leraar|leermeester
docente|lerares
docenten|leraren
doch|echter|niettemin|maar|nochtans
doctoraat|doctorsgraad
doctoren|dokters
dode|overledene
dodelijk|fataal
doden|doodmaken|doodslaan|kapotmaken|liquidatie|liquideren|ombrengen|slachten|mollen|uitroeien|vermoorden|vernietiging
doe|doen|doet|handelen
doek|lap|schilderij|poetslap|schildering|vod|schilderstuk|tableau
doeken|lappen
doel|doelwit|mikpunt
doelbewust|resoluut
doelman|doelverdediger|goalie|keeper
doelmatigheid|effectiviteit
doelpunt|goal
doelwit|mikpunt
doen|doet|exporteren|uitrichten|verrichten|tenuitvoerleggen|uitvoeren
doend|uitvoerend
doezelen|dommelen|gedommel|sluimeren|soezen
doezelig|duf|soezerig|geestdodend|suf|versuft
dof|glansloos|versuft
doktersbezoek|huisbezoek|ziekenbezoek
dolen|ronddwalen|waarden|waren
dolfijn|tuimelaar
dolheid|furie|razernij
dollen|ravotten|stoeien
dolletjes|enig
dom|onverstandig
dominant|gezaghebbend|vooraanstaande|prominent
dominantie|overheersend
dominee|pastor|predikant|prediker|voorganger
domineren|gezaghebben|overheersen
domkop|domoor|stommeling|sufferd
dommekracht|krik
dommelen|gedommel|sluimer|soezen|sluimeren
domoor|minkukel|oen|onnozelaar|sufferd|stommeling
dompelen|onderdompelen
domper|kaarsendover
domweg|simpelweg
donateur|schenker
donatie|gift|schenking
donaties|giften
donderbui|onweer
donderen|onweren
doneren|geeft|geven|schenken
donker|duister|onverlicht
dons|nesthaar
doodgaan|inslapen|omkomen|overlijden|uitgevallen|sterven|uitvallen|wegvallen
doodgraver|grafdelver
doodkist|lijkkist
doodmoe|doodop|op
doods|uitgestorven|verlaten
doodschieten|neerleggen|neerschieten|overhoopschieten
doodslag|moord
doodziek|kotsmisselijk
doofstomheid|stomheid
dooi|dooiweer
dooier|eigeel
doolhof|labyrint|warboel|warhoop
doop|doopsel
doopnaam|gedistingeerd|voornaam
door|doorheen|om|onderbrak|ingevolge|vanwege|voort|wegens
doorbraak|doorbreken|doorbreking
doorbreken|doorbreking
doorbrengen|slijten|verslijten
doorbuigen|doorzakken
doordat|omdat
doordrenken|impregneren
doordrongen|doortrokken|vervuld
doorgaan|doorzetten|standhouden|volharden
doorgaans|normaliter
doorgang|doorloop|gang|gangpad
doorgestreept|geschrapt
doorgeven|doorspelen|doorvertellen
doorgrond|doorzien
doorhalen|schrappen
doorhebben|doorzien
doorloop|gangpad
doormeppen|doorslaan|verklappen
doorn|stekel
doorschijnend|doorzichtig|transparant
doorsijpelen|doorzijgen|filteren
doorslaan|klikken|verklappen|verklikken
doorslikken|inslikken|kwelders|slikken
doorsneden|doorsnijdingen|gemiddelden
doorspelen|doorvertellen
doorspoelen|doortrekken|wegspoelen|spoelen
doorstaan|uithouden|vergaan|verduren|verslijten|verteren
doorstikken|naaien|stikken
doorstroming|vloeing
doorsturen|doorzenden
doortastend|kordaat|voortvarend|krachtdadig|krachtig
doortrapt|geniepig|geraffineerd|kien|listig|uitgekookt|smaakvol
doortraptheid|gladheid|glibberigheid|sluwheid
doortrekken|wegspoelen
doortrekker|transmigrant
doortrokken|vervuld
doorvragen|ondervragen|uitvragen
doorwerken|overwerken
doorzetten|volharden
doorzetter|taaie
doorzettingsvermogen|vasthoudendheid|volharding
doorzichtig|transparant
doorzichtigheid|transparantie
doorzijgen|filteren|filtreren|zeven
doos|opbergdoos|strafgevangenis
doosje|schede|vagina
dope|drug|narcotica
doppen|pellen|schillen
dor|droog|schraal|pover|verdord
dorheid|droogheid|droogte|karigheid|schraalheid|magerte
dorp|gat|gehucht|kerkdorp|vissersdorp
dorpel|drempel
dorpsraad|verbijzonderen
dosis|hoeveelheid|portie
dossier|file
dossiers|mappen|ordners|papieren
douane|douanekantoor|grenskantoor|grenspolitie
douanebeambte|douanier
douanekantoor|grenskantoor
doubleren|verdubbelen|vermenigvuldigen
douche|stortbad
doven|smoren|uitblussen|uitdoven
dozijn|twaalf|twaalftal
draad|garen
draadschaar|kaartjeskniptang|kniptang
draagbaar|goedzittend
draagbalk|latei|ligger|schoorbalk|steunbalk
draai|kronkel|twist|verdraaiing
draaiboek|filmscenario|werkplan|scenario
draaiboeken|filmscenario's|werkplannen
draaien|kantelen|keren|kolken|rondtollen|wenden|wentelen|omdraaien|ronddraaien
draaier|draaikont|veinzer
draaitafel|grammofoon|platenspeler
drager|eigenaar|kruier
drainage|ontwatering
dralen|talmen
drama|schouwspel|stuk|toneelstuk
drama's|
drammen|zeuren
drank|gedistilleerd|spirituali
drankbuffet|tapkast
drankwinkelier|slijter
drassig|modderig|moerassig|slibachtig
dreef|laan|landweg|paadje|pad
dreigend|duister|eng|griezelig|sinister
drenkeling|verdronkene
dresseren|dressuur
dressoir|porseleinkast
dressuur|paardendressuur
drie|drietal|trio
driehoek|triangel
driesprong|splitsing
driftkikker|driftkop|heethoofd
driftkop|heethoofd
drijfhout|wrakhout
drijfnat|kletsnat
drijfveren|stimuli
drijver|koetsier
drilpudding|gelatinepudding
dringen|duwen|stompen|voortduwen
dringend|spoedeisend|urgent
drinkbeker|mok|tuimelaartje
drinken|zuipen
droefgeestig|melancholisch
droefgeestigheid|melancholie
droesem|moer
drogen|droogmaken|opdrogen|uitdrogen
dromer|fantast
dromerig|soezend
drommel|stakker|stumper
dronkaard|zatlap
droog|schraal|verdord
droogheid|droogte
droogleggen|inpolderen
droom|waanvoorstelling
drop|druppel
druilerig|miezerig
druiloor|flapdrol|mafkees
druipen|druppelen
druivensuiker|fructose
drukken|klikken|knellen|overbrieven|omklemmen|verklappen|vastklemmen|verklikken
drukker|wegloper
drukkerij|krantendrukkerij
drukkers|plaatdrukkers
drukpers|media|pers
drukte|gedrang|oploopje|toevloed|toeloop
drummer|percussionist
druppelen|druppen|sijpelen
dualisme|tweeheidsleer|tweeslachtigheid
dubbel|duo|stuntman|twee
dubbelzinnig|meerduidig
dubben|nasynchroniseren
duel|match|wedstijd
duf|suf
duidelijk|manifest|verhelderend|verstaanbaar
duik|sprong
duikboot|onderzeeboot
duiken|vooroverduiken
duimstok|maatstaf
duister|duisterheid|geheimzinnig|louche|onbetrouwbaar|onduidelijkheid|verdacht
duisterheid|onduidelijkheid
duizend|mille
duldbaar|toelaatbaar
dundoek|vlaggendoek
dunnetjes|schraal|sobertjes
duo|twee
duo's|
dupe|lul|pineut|sigaar
duplicaat|fotokopie|kopie|transcriptie
durf|gewaagdheid|lef|moed
durven|riskeren|wagen
dusdanig|zulk
dutje|tukje
duur|hardloopwedstrijd|loop|vlucht|voortgang
duurt|toestaan
duw|duwtje|por|stoot
duwen|opschuiven|rammen|voortduwen|vooruitduwen|vooruitschuiven|stompen|stoten
duwtje|oplawaai|por|schaakstukverplaatsing|stootje|opstopper|schaakzet|stoot|zet
dwaaltocht|zwerftocht
dwaas|idioot|imbeciel|onbenul|onnozelaar|mafkees|zwakzinnig
dwaasheid|gekkigheid|gekte|ongerijmdheid
dwangbevel|karwij|order|klus|opgave|schoolopdracht
dwarszitten|ergeren|hinderen|prikken|steken
dynastie|geslacht|sekse|stamhuis
dyslexie|leesblindheid
eb|laagtij
echec|fiasco|mislukking
echo|geluidsweerkaatsing|weerklank
echt|eigenlijk|huwelijk|onvervalst|feitelijk|huwelijksinzegening|nuchter|re
echte|werkelijke
echtgenoten|eega's|kerels|mannen|partners|vrouwen
economie|economiestudie|staathuishoudkunde
economisch|financieel|spaarzaam|geldelijk
edelmoedigheid|grootmoedigheid
educatie|onderricht|onderwijs|opleiding
eega's|
eelt|eeltlaag
een|eentje|ene
eendrachtig|eensgezind|harmonieus|saamhorig|unaniem|welluidend|solidair
eenheid|maat|unie
eenmaal|eenmalig
eenmans|eenpersoons
eenparig|eensgezind|unaniem|eenstemmig
eens|ooit
eensgezindheid|unanimiteit
eensklaps|onverwacht|opeens|pats|plots
eenstemmig|unaniem
eenvoud|eenvoudigheid|ongekunsteldheid|soberheid
eenvoudigweg|simpelweg
eenzaamheid|verlatenheid
eenzelvig|introvert|teruggetrokken
eerbetoon|hommage
eerbewijs|prijs
eerbewijzen|honneurs
eerbied|ontzag
eerbiedigen|hoogachten|verering
eerder|voordien|voorheen|vroeger
eerlijk|fair|trouwhartig
eerlijke|rechtschapene
eerlijkheid|oprechtheid|rechtschapenheid
eerloos|infaam
eerst|vantevoren|vooraf|voorafgaand|voorgerecht
eetgelegenheid|eethuis|herbouwing|herstelwerkzaamheden|restauratie
eetgewoonten|voedingsgewoonten
eetlepel|lepel|opscheplepel
eetservies|servies
eettafel|leestafel|tafel
eetzaal|restauratie|restauratiezaal
eeuwig|onvergankelijk
effecten|gevolgen|pandbrieven|resultaten
effenen|egaliseren|gladmaken|platmaken|gelijkmaken|vereffenen
effenheid|vlakheid
egaliseren|gladmaken|vereffenen
eigen|inherent
eigendunk|eigenwaan|zelfingenomenheid
eigenhandig|ikzelf|zelf
eigenlijk|werkelijk
eigenschap|hoedanigheid|karaktertrek|kenmerk|kenteken|merkteken
eigentijds|hedendaags|modern|nieuwerwets
eigenwaarde|zelfrespect
eigenwijs|eigenzinnig
eik|eikenboom
eiland|schiereiland
eind|staart
eindelijk|tenslotte
einder|gezichtseinder|horizon|kim
eindexamen|examen
eindfase|slotfase
eindig|vergankelijk|voorbijgaand
eindigen|lozen|staken|uitscheiden|staking
eindje|stukje
eindopbrengst|eindresultaat
eindrapport|eindverslag
eindstand|uitslag
eindstreep|finish
eindzege|resultaat
eis|invordering|rechtsvordering|vordering
eisen|inmanen|opeisen|reclameren|vereisen|invorderen|opvorderen|vergen|vorderen|verlangen
eiser|reclamant
eivormig|ovaal
eiwit|prote
ejaculatie|zaadlozing
ejaculeren|klaarkomen
elastisch|rekbaar|veerkrachtig
elegance|finesse
elegant|stijlvol
elegantie|gratie
elektriciteit|stroom
elektriciteitsdraad|ketting|snoer
elektriciteitsgeleider|geleider|stroomgeleider|warmtegeleider
elektriciteitsnet|lichtnet
elektriciteitssnoer|stroomdraad|stroomkabel
elektriciteitssnoeren|koorden|snoeren
elektriciteitsstoring|kortsluiting
element|factor
elf|elfje|elftal|voetbalelftal
elftal|voetbalelftal
elimineren|verwijderen|wegwerken
elkaar|elkander|jawel|mekaar
ellende|kommer|mis|kwel
ellendeling|kuttenkop|rotzak|smeerlap
ellendig|meelijwekkend|miserabel
ellips|meningsuiting|uitlating
elpees|platen
emailleren|moffelen
emanciperen|vrijmaken
emballage|omhulsel|verpakking
emballeren|inpakken|inpalmen|verpakken
embleem|zinnebeeld
emblemen|zinnebeelden
embouchure|mondstuk
embryo|foetus
emigratie|landverhuizing
eminentie|hoogheid|verhevenheid
emissie|uitstoot
emotie|ontroering
en|plus|plusteken
energiek|vief
engel|hemelgeest
engelachtig|lief
engerd|griezel
enkel|enkelvoudig|onderbeen|slechts|voetgewricht|uitsluitend
enorm|gigantisch|ontiegelijk|reuze|kolossaal
enquete|opinieonderzoek
enthousiast|geestdriftig
entree|hal|overloop|vestibule
enveloppe|wikkel
enz|enzovoort|enzovoorts|etc
enzovoort|enzovoorts
enzovoorts|etc
epidemie|pest|plaag
epileren|ontharen
epiloog|nawoord|slotrede|slotwoord
epistel|strafpredikatie
epos|heldendicht
equivalent|omschrijving
erbij|erop
erectie|stijve
eren|hoogachten
erfelijk|overdraagbaar
erfenis|nalatenschap
erfgoed|nalatenschap
erg|hevig
erger|kwalijker|moeilijker|slechter
ergeren|irriteren
ergernis|irritatie|wrevel
ergonomisch|gebruiksvriendelijk
ergst|uiterst
erkend|gerenommeerd
erkenning|toegeving
erosie|verweren|verwering
erotiek|wellust|zinnelijkheid
erotisch|sexy
eruitgaan|uitstappen
ervaren|geoefend
escadrille|squadron
essay|verhandeling|werkstuk
esthetisch|smaakvol
etage|intensivering|verdieping|woonlaag
etalage|uitstalkast
etalagepop|ledenpop|mannequin
etaleren|exposeren|tentoonspreiden|tentoonstellen|presenteren|uitstallen|tonen
eten|leegeten|nuttigen|opeten
ethiek|moraal|zedenleer
ethisch|moreel
etiket|label|sticker|plakker
etiketten|labels|prijskaartjes
ettelijk|overlijden|verscheiden
etter|etterbak|pus
etterbuil|puistje|steenpuist|zwelling
etui|houder|koker|pennendoosje|pennenhouder
euforie|vreugde|welbehagen
evacueren|leegruimen|ontruimen
evalueren|ontwikkelen
evenredig|proportioneel
eventueel|misschien|mogelijk|wellicht
evenwel|niettemin|toch
evenwichtig|stabiel|stevig
evenwijdig|gelijktijdig|parallel
ever|everzwijn
evident|overduidelijk
evolueren|ontwikkelen
exact|precies
examinator|onderzoeker|tester
examineren|toetsen|uittesten
excerpt|extract|samenvatting|resum
exclusief|speciaal|uitsluitend
excursies|toeren
excuus|pardon|smoes|reden|uitvlucht|verontschuldiging|voorwendsel
executie|moord|strafuitvoering|tenuitvoerlegging|terechtstelling|uitvoeren|uitvoering
executiewaarde|veilingwaarde
exit|uitgang
exodus|leegloop|uittocht
expanderen|verwijden
expediteur|transporteur|vrachtondernemer|vervoerder
experiment|proef|proefneming
experimenteer|oefen|probeer
experimenteren|uitproberen
exploderen|klappen|ontploffen|opspringen|ploffen|springen
exploitant|uitbater
exploitatie|exploiteren|uitbuiting|uitbuiten
exploiteren|ontdoen|uitbuiten
exploreren|verkennen
explosief|granaat|ontplofbaar|projectiel
export|uitvoer
exporteren|uitvoeren
exposanten|tentoonstellers
exposeren|gedragswijze|tentoonstellen|optreden|tonen|vertonen|performen
expositie|tentoonstelling|uiteenzetting
exprespost|koerier|loopjongen|renbode
expressie|gelaatsuitdrukking|gezichtsuitdrukking|uitdrukking
expressief|sprekend
extase|geestvervoering|trance|vervoering
extern|uitwonend
extra|reserve|toegevoegd
extract|samenvatting
extremiteit|ledemaat
ezelsbrug|geheugensteun
ezelsoor|vouw
fabriceren|maakt|produceren|maken|vervaardigen|vervaardiging
fabrikant|producent|producer
facet|opzicht
factotum|manusje-van-alles
factureren|gefactureerd
fakkel|flambouw|toorts
falen|mislukken
faliekant|onvoorwaardelijk|vierkant|volkomen|volstrekt
falsificatie|vervalsing
falsificeren|kopi|vervalsen
familie|geslacht|gezin|huisgezin|stamhuis
familieband|gezinsverband
familielid|gezinslid
familievader|huisvader
fanaat|fanaticus|ijveraar|zeloot|fanatiekeling
fanaticus|fanatiekeling
fans|ventilatoren
fantaseren|verzinnen
fantasie|fictie|verbeelding
fantastisch|geweldig|super|supergaaf
farce|schertsvertoning
farceren|opvullen|vullen
fascineren|intrigeren|konkelen
fase|ontwikkelingsfase|ontwikkelingsstadium|stadium
fasen|stappen|voetstappen
fatsoen|fatsoenlijkheid|keurigheid|manieren|netheid|omgangsvormen
februari|schrikkelmaand|sprokkelmaand
fee|toverfee
feedback|terugkoppeling
feeks|haaibaai|heks|helleveeg
feestdag|jaarfeest
feestje|partij|partijtje
feestvarken|jubilaris
feilloos|voortreffelijk
feit|waarheid
fel|pinnig|scherp|vinnig
felicitatie|gelukwens
feliciteren|gelukwensen
feminien|vrouwelijk
fenomeen|verschijnsel
ferm|onwrikbaar|standvastig
fermenten|fermenteren|gisten
Ferro|ijzer
fictief|gefingeerd|verdicht|onecht
fiets|rijwiel|tweewieler
fietsen|wielrijden
fietsenhok|rijwielstalling|stalling
fietser|wielrenner|wielrijder
fietsslot|slot
figuur|opendag|personage
figuurlijk|grote
fijn|grappig|klein|prettig|subtiel|komisch|leuk
fijne|kerks
fijngebouwd|lichtgebouwd|slank|spichtig|tenger
fijngevoelig|teer
fijnhakken|hakken
fijnproever|gastronoom|kenner|levensgenieter|liefhebber|lekkerbek|smulpaap
fijnstampen|stampen|stampvoeten
fijntjes|smaakvol|verfijnd
fijnzinnigheid|tact
fiks|flink
fiksheid|kracht|sterkte
filantroop|mensenvriend
file|opstopping|verkeersopstopping
filet|haasfilet|visfilet
filiaal|vestiging
film|filmrolletje|speelfilm
filmmuziek|soundtrack
filmscenario|scenario
filmspoel|schietspoel|spoel
filosofie|wijsbegeerte
filosoof|wijsgeer
filter|filterzakje
financieel|geldelijk
financier|geldschieter|suikeroom
fingeren|veinzen|verzinnen|voorwenden
fit|getraind|gezond
fitter|gasfitter|installateur|waterfitter
flacon|flesje
fladderen|rennen|vliegen|wapperen|vlinderen
flank|kant|zijkant|rand
flankerend|ondersteunend
flard|homp|vod|lap
flauw|lui|stug|lusteloos|mat|slap
flauwte|katzwijm
flensje|pannekoek|pannenkoek
fles|platvink|wijnfles
flesopener|opener
flets|futloos|verschoten|gematteerd|mat
flikflooierig|slijmerig|stroperig|taai-vloeibaar
flikken|klaarspelen
flink|stoer
flip-over|flipover
flirt|geflirt
flirten|lonken|sjansen
flits|flitslicht
floers|greintje|zweem|snufje
fluctueren|uiteenlopen|vari
fluister|inbraak|kraak
fluisteren|lispelen|smiespelen|sissen|smoezen
fluiten|pijpen
fluweel|fluwelen|velours
fluwelen|velours
fonds|pensioenfonds
fonkelen|fonkeling|stralen|mousseren|sprankelen
fonkeling|glinstering|sprankelen|vonk
fonkelnieuw|splinternieuw
fooien|inlichtingen|tips
fopspeen|speen
fopspenen|spenen
forceren|overbelasten
formaat|grootte|omvang
formaliteit|hamerstuk
formeel|informeel
formuleren|verwoorden
formulier|invulformulier
fornuis|keukenfornuis|kookkachel|stookinrichting
forsheid|stevigheid
foto|kiek|plaatje
fotohandel|fotozaak
fotokopie|kopie
fotomodel|mannequin|model|prototype
fouilleren|visiteren
fout|lapsus|misstap|onjuist|onjuistheid|vergissing
fouten|gebreken|onjuistheden|mankementen|ongemakken
foutloos|vlekkeloos
foyer|koffiekamer
franc|frank|rechttoe
franco|vrachtvrij
franje|poespas
frank|klinkklaar|open|rechttoe
frankeerkosten|porto
frase|gezegde|zegswijze|uitdrukking
fraudeur|zwendelaar
frauduleus|onregelmatig
freak|maniak
frees|slijper|slijpmachine
frequenter|vaker
frequentie|frequentieband|golflengte
friemelen|frunniken
friet|frites|patat
frigide|koel|kou|koude
frituur|frituurpan|patatkraam
front|gevelbreedte|vuurlijn|pui|vooraanzicht
fruitautomaat|gokautomaat|speelautomaat
frustreren|ontgoochelen
fuiven|trakteren|uitdelen
fulltime|volledig
functiebeschrijving|taakomschrijving
functionaris|officier|stafmedewerker
functioneren|werken
fundamenteel|onontbeerlijk|wezenlijk
fundamenten|grondslagen|onderbouwsels|grondvesten
funderen|grondvesten|onderbouwen|onderheien
funest|rampzalig
furie|giftigheid|kwaadheid|razernij|woede
furore|roem
fuseren|samengaan|samensmelten|versmelten
fusie|samensmelting
fusies|overnames
fust|vat
futiliteit|kleinigheid
futloos|lamlendig|lusteloos|landerig|vervelend
futloosheid|loomheid|matheid
fysicus|natuurkundige
fysiek|lichamelijk|lijfelijk
fysisch|natuurkundig
gaaf|geschikt|schitterend|tof
gaanderij|galerij|zuilengang|trans
gaap|geeuw
gaard|tuin
gaarne|graag
gaas|harmonikagaas|ijzergaas|kippengaas
gaatje|gat|waterlek|lek
gadget|snufje|zweem
gaffel|hooivork|riek|vork
gaffelvormig|gespleten|gevorkt
gage|salaris
gala|galabal|hofbal|hoffeest|hofkledij|staatsiekleding
galerij|zuilengang
galg|strop
galm|klankweerkaatsing|resonantie
galmen|naklinken|resoneren|weergalmen
galvaniseren|verzinken|verzinking
game|spel
gang|snelheid|spoed|tempo|vaart
gangbaar|gebruikelijk|gewend|gewoon|normaal
gangmaker|mentor
gapen|geeuwen
garanderen|vastmaken|waarborgen|verzekeren
garant|waarborger
garderobe|klerenkast|vestiaire
gareel|harnas|leidsel|schorriemorrie|pantser|toom|tuig
garenklos|klos
garnaal|steurgarnaal
garnering|versiering
garneringen|versieringen
garnituur|gerechtsdecoratie
gasbrander|gaspit|gasstel
gasbuis|gasleiding
gasfitter|installateur|waterfitter
gasgeiser|geiser|heetwatergeiser|keukengeiser
gashaard|gaskachel
gaspit|gasstel
gassen|ontgassen
gast|log|stamgast
gastenboek|hotelregister
gastenkamer|logeerkamer
gasthuis|herberg|hospitaal|logement|ziekenhuis
gastvrijheid|hartelijkheid|jovialiteit|tederheid
gave|talent
gazon|grasveld
ge|gij|jij
ge-olied|gesmeerd
geaccepteerd|goedgekeurd
geavanceerd|gevorderd|progressief|vergevorderd|vooruitstrevend
geavanceerde|moderne
gebaar|geste
gebak|taart
gebakje|taartje
gebedshuis|moskee
gebergte|kaap
gebeuren|plaatsvinden|voorvallen
gebeurtenis|voorval
gebied|landstreek|regio|streek
gebit|kunstgebit
geboeid|gefascineerd|geketend|vastgebonden
gebogen|gekromd|gewelfd|voorovergebogen|krom
geboortedag|geboortedatum
geboorteland|vaderland
geboren|geschapen
gebouwen|panden
gebrand|gestookt
gebrek|handicap|krapte|lichaamsgebrek|schaarste|tekort
gebreken|mankementen|ongemakken|ongerieven
gebroed|gespuis|schorriemorrie
gebroken|geradbraakt|stukgebroken|verbroken
gebrom|gemopper|geroezemoes|gezoem
gebruik|gewoonte
gebruikelijk|gewoon|normaal
gebruiken|gewoontes|tradities|usances
gebruiksaanwijzing|handboek|handleiding|handleidingen|leidraad
gebruikt|tweedehands
gebrul|gegil|geschreeuw|gekrijs
geconcentreerd|ingespannen|verdiept
gedaald|gezakt|verzakt
gedaante|geestverschijning|schim|uiterlijk|verschijning
gedaanteverwisseling|metamorfose|vormverandering|transformatie
gedachte|veronderstelling
gedachtegang|gedachtengang|redenering
gedachtegoed|gedachtengoed
gedachtelezen|gedachtenlezen
gedachten|gedenken|herdenken|overwegingen
gedachtenis|nagedachtenis|souvenir
gedachtensprong|gedachtesprong
gedeclareerde|vermelde
gedeeld|meegevoeld|verdeeld
gedegen|intensief
gedelegeerde|handelsreiziger|plaatsvervanger|zaakgelastigde|handelsvertegenwoordiger|representant|vertegenwoordiger
gedelegeerden|gedeputeerden
gedempt|halfluid
gedenken|herdenken
gedenkpenning|geldstuk|penning
gedenktekens|monumenten
gedenkwaardig|heugelijk|memorabel|verblijdend
gedetineerde|gevangene
gedicht|vers|versgebakken|versregel
gediplomeerd|gekwalificeerd
gedistingeerd|gewichtig|illuster
gedocumenteerd|vastgelegd
gedoogde|gedulde|verduurde
gedrag|rijrichting
gedragen|ondersteund
gedram|gemier|gezeur|gezanik
gedrocht|monster|mormel|wangedrocht|specimen
gedrochtelijk|mismaakt|misvormd
gedruis|geluid|rumoer|lawaai|tumult
gedurende|lopend|tijdens
geduwd|gestoten
geeft|geven|schenken|verstrekken
geelkoper|messing|tombak
geest|geestverschijning|mentaliteit|psyche|wezen|ziel
geestelijk|intern|kerkelijk|psychisch|inwendig|kerksgezind|psychische
geesteszieke|gek|krankzinnige
geestig|geinig|grappig|koddig|komisch
geestvervoering|trance|vervoering
geflipt|gek
gegaan|getogen
gegevensverstrekking|uitgifte|verstrekking
gegil|geschreeuw
gegomd|gelijmd
gegriefdheid|verontwaardiging|verstoordheid
gegroet|groet|groeten|salueren
gehaaid|geslepen|gewiekst|leep
gehandicapt|gehandicapte|invalide
gehandicapte|invalide|mindervalide
gehandicapten|invaliden|mindervaliden
geheim|heimelijkheid|vertrouwelijk
geheimzinnig|mysterieus|raadselachtig
geheugen|herinneringsvermogen|memorie
geheugenis|herinnering|herinneringsvermogen|herrinnering|memorie|nagedachtenis
gehoor|publiek
gehoororgaan|oor
gehoorzamen|luisteren
gehuil|gejammer|gejank|wolvengehuil
geil|opgewonden
geinig|grappig
geintje|pretje
geirriteerd|gemelijk|stuurs
geiser|heetwatergeiser|keukengeiser
gek|gestoorde|getikt|hansworst|idioot|malloot|kwast|zwakzinnige|zot|kwibus
gekabbel|kabbeling
gekamd|gekuifd
gekanker|geklaag|gelamenteer
gekarteld|getand
gekeuvel|gekwebbel
gekken|gestoorden
geklaag|gelamenteer
gekleurd|kleurig|tendentieus|vooringenomen
geknuffel|liefkozing
gekoeld|koel
gekrijs|geschreeuw
gekrioel|gewriemel
gekromd|krom
gekronkeld|geslingerd
gekunsteld|gewrongen
gelaatsuitdrukking|gezichtsuitdrukking
gelaten|lijdelijk|lijdzaam|sto|passief
gelatenheid|lijdzaamheid
gelatine|gelei
gelazer|moeilijkheid|narigheid|trammelant
geld|poen|strafbaar
gelden|geldt
Gelderse|mooi
geldigheid|gelding|validiteit
geldigheidsduur|looptijd
geldkist|schatkist|staatskas
geldlening|hypotheek|lening
geldontwaarding|inflatie|prijsstijging|prijsverhoging
geldschieter|suikeroom
geldstroom|subsidie|tegemoetkoming|toelage
geldstuk|munt|muntstuk|penning
geldtekorten|tekorten
geldzending|gelijkspel|remise
geleed|geleedpotig
geleerde|opgeleide
gelegen|gesitueerd|liggend
gelegenheden|uitgaansgelegenheden
gelegenheid|mogelijkheid|plaats|plek|ruimte
geleide|optocht|stoet|processie
geleider|stroomgeleider|warmtegeleider
gelezen|lezen
gelid|rang|rangorde|rij
geliefde|vlam
gelijk|gelijksoortig|identiek|soortgelijk
gelijkaardig|gelijksoortig
gelijke|weerga
gelijkenis|overeenkomst
gelijkgestemde|gelijkgezinde
gelijkmaken|gladmaken|nivelleren
gelijkmatig|gestaag|pak|tenue|uniform
gelijknamig|homoniem
gelijkschakeling|synchronisatie
gelijksoortig|vergelijkbaar
gelijkspel|remise
gelijktijdig|simultaan|synchroon|tegelijk|tegelijkertijd
gelofte|toezegging
geloof|religie
gelui|klokgelui
geluid|rumoer|sound
geluiden|klanken
geluidloos|heimelijk|zachtjes|onderhands|stilletjes
geluidloze|stomme
geluidsband|magneetband
geluidshinder|geluidsoverlast
geluidssterkte|volume
geluidsweerkaatsing|weerklank
gelukt|lukken|slagen
gelukzalig|verrukt|zielsgelukkig|zalig
gelukzaligheid|heerlijkheid
gemaai|maaien
gemaakt|geproduceerd|vervaardigd
gemachtigde|gevolmachtigde
gemak|gemakkelijkheid|kalmaan
gemanierdheid|toneelspel
gematigdheid|ingetogenheid|matigheid|zedigheid
gematteerd|mat
gemeen|gering|klein|laag|min
gemeengoed|gemeenschappelijk|tezamen
gemeenschap|maatschappij|paring|samenleving|symbiose
gemeenschappelijkheid|overeenkomst
gemeentebestuur|gemeenteraad|stadsbestuur
gemeentehuis|raadhuis|stadhuis
gemeenteraad|notabelen|stadsbestuur
gemengd|gem
gemiddeld|modaal
gemier|gezeur
gemoed|inborst
gemoedelijk|joviaal
gemoedsbezwaar|gewetensbezwaar|scrupule
gemoedsgesteldheid|humeur|inborst
gemoedstoestand|humeur|stemming
gemoedsuiting|ontboezeming
genade|goedertierenheid|pardon|vergevingsgezindheid|gratie|kwijtschelding|vergeving|vergiffenis
genadeloos|hardvochtig|meedogenloos|ongenadig|wreed
genadig|vergevingsgezind
geneeskunde|heelkunde|medicijnen
geneeskundig|medicinaal|medisch
geneesmiddel|middel|remedie
generaal|veldheer
generatie|mensenleven
genereus|goedgeefs|rijkelijk|royaal
genezen|hersteld
genezer|heelmeester
genezing|heling|herstel|reparatie
genieten|genot|lust|smullen|plezier
genietingen|lusten|wellusten
genivelleerd|vereffend
genoeg|toereikend|voldoende
genoemd|gezegd|medegedeeld|verwoord
genoteerd|opschrijven
geometrie|meetkunde
geoogst|gewonnen
geoorloofd|toelaatbaar
geopend|ontsloten
gepassioneerd|heftig|hevig
gepast|geschikt|ge
gepekeld|gezouten
gepeupel|natie|volk|werkvolk
gepiep|getjilp
geplaatst|plaatsen|situeren
gepleegd|voltooid
geponst|gestanst
geprezen|gezegend
geprikkeld|ge|ontstemd
geprikkeldheid|lichtgeraaktheid|prikkelbaarheid
geproduceerd|vervaardigd
geprononceerd|uitgesproken
geraas|tumult
gerecht|hof|schotel|rechtbank
gerechtelijk|justitieel|rechterlijk
gerechtigd|gewettigd
gerechtigheid|gewoonterecht|recht
gerechtshof|rechtbank
gereedschap|gerei|werktuig
gerelateerd|verwant
gereserveerdheid|terughoudendheid
gerespecteerd|ge
gericht|gestructureerd
gerichtheid|ori
gerimpeld|rimpelig
geringe|kleine|nietig|nietige
geringste|kleinste|miniemste|minste
geroddel|roddels
geroep|geschreeuw|oproep|roep|reputatie
geroffel|getrommel
geronnen|gestold
gerst|mout
gerucht|roddel
geruchtmakend|opzienbarend|verbazingwekkend
geruis|ruis
geruststellend|rustgevend
geruststelling|kalmering|opluchting
geschelpt|geschulpt
geschenk|gift
geschiedkundig|historisch
geschiedkundige|historicus
geschift|krankjorum|kwibus|mesjogge|mafkees|zot
geschil|onenigheid|ruzie|twist
geschrei|vergieten
geschreven|pennen|schrijven
geschrevene|kopij|schriftuur|manuscript|tekst
geschutkoepel|koepel
geselen|kastijden|tuchtigen
gesetteld|gevestigd|gezeten|woonachtig
gesitueerd|liggend
gesjacher|handjeklap
geslaagd|succesvol
geslacht|kunne|sekse
geslachtelijk|seksueel
geslachtloos|neutraal|onzijdig
geslachtsdeel|geslachtsorgaan
geslachtsgemeenschap|omgang|verkeer|processies|ronde
geslepen|sluw
gesloopt|weggebroken
geslotenheid|g|verlegenheid
gesmeek|smeken
gespannen|gestressd|opgejaagd
gespecialiseerd|specialistisch
gespikkeld|gestippeld
gespleten|gevorkt
gespreksgroep|praatgroep
gespuis|schorriemorrie|tuig|uitschot
gespuug|spuwen
gestalte|silhouet
gesteente|steen
gesteld|opperen|poneren|pretenderen
gestopt|opgehouden
gestorven|overleden
gestressd|opgejaagd
gestresst|overspannen|overwerkt
gesuikerd|zoet
getaand|tanig
getal|numero|nummer
getalenteerd|talentvol
getalsmatig|numeriek
getekend|tekenen|uittekenen
getij|tij
getintel|tinteling
getogen|opgevoed
getuigenis|getuigenverklaring|testimonium|verklaring
getuigschrift|referentie
geur|geurtje|reuk|reukzin
geuren|pralen|rieken|ruiken|pronken|stinken
geurig|welriekend
geurtje|odeur|parfum
gevaar|onheil|onheilsdreiging|onveiligheid|ramp
gevaarlijk|hachelijk|risicovol|riskant
gevaarte|kolos
gevangenis|strafgevangenis
gevangenname|inhechtenisneming|inverzekeringstelling|vrijheidsberoving
gevat|scherp|snedig
gevecht|kamp
gevechtstroepen|troepen
gevederte|opveren|pluimage|veren
gevel|pui|voormuur|voorgevel
geveltoerist|inbreker
gevestigd|gezeten|woonachtig|zittend
gevierd|gewild|populair
gevlucht|ontvlucht
gevoel|instinct|intu|sentiment
gevoelig|ontvankelijk|sentimenteel|vatbaar
gevoeligheid|hartelijkheid|kwetsbaarheid|liefkozing|tederheid
gevoelsmatig|intu
gevoelvol|ge
gevolgen|prestaties|resultaten
gevolgtrekking|slotsom
gevorderd|vergevorderd
gevuld|vol
gewas|planten|vegetatie
geweer|pistool|vuurmond
geweermagazijn|magazijn|voorraadkamer|voorraadmagazijn
geweerschot|kanonschot|schot|scutting|tussenschot
gewei|horens
geweldig|groots|massaal|omvangrijk
geweldloos|sereen|vreedzaam|vredelievend
gewelf|kelder|plafond
gewend|gewoon
gewenning|inburgering|verslaving
gewest|kunstzijde|rayon
gewetensbezwaar|scrupule
gewetenskwestie|gewetensvraag
gewichtstuk|kanon|stuk
gewin|profijt
gewonde|mikpunt|offer|offerdier|prooi
gewoonterecht|recht
gewoontes|overleveringen|usances|zeden|tradities
geworden|werd|worden|word
gewring|uitwringen|wringen
gezag|kabinet|regering
gezaghebben|heersen|overheersen|regeren
gezaghebbend|vooraanstaande
gezakt|verzakt
gezamenlijk|samen|tezamen
gezang|lied|liedje
gezanik|gezeur
gezegd|medegedeeld|verwoord
gezegde|leus|spreuk|zegswijze
gezellig|knus|leuk
gezelschap|soci
gezeten|zittend
gezetheid|zwaarlijvigheid
gezeur|gezever
gezichtsbedrog|hallucinatie|zinsbegoocheling|zinsbedrog
gezichtsbepalend|toonaangevend|vooraanstaande
gezichtsuitdrukking|uitdrukking|zegswijze
gezichtsveld|panorama|prospect|uitzicht|zicht
gezien|waargenomen
gezindheid|opinie|overtuiging
gezinsbijstand|gezinshulp|gezinsverzorging
gezinshulp|gezinsverzorging
gezinsvoogd|voogd
gezond|gezondheidsbevorderend
gezondmaking|saneren
gezwel|knobbel|tumor
gezwindheid|rapheid|vlugheid|snelheid
gids|reisbegeleider|reisgids|reisleider|reisleidster
gidsing|sturing
giek|kluiver
gierig|inhalig|vrekkig|schraperig
gierigaard|krent|schraapmes|vrek|schraper
gieten|schenken|storten|uitstorten|stortregenen
gietijzer|ruwijzer
gietmal|gietvorm|mal|matrijs|modelvorm
gietvorm|krankjorum|modelvorm|maf|sjablone|mal
gif|toxine|vergif
giftigheid|razernij|venijn|venijnigheid|virulentie
gigant|reus|titaan
gigantisch|immens|kolossaal|reusachtig
gij|je|jij
gijzeling|gijzelname|lijfsdwang
gil|kreet|schreeuw|roep
gildepatroon|heilige
gillen|janken|schreeuwen
ginder|ginds
giro|girorekening|postgiro
gisten|rubriek
gister|gisteren
gistermorgen|gisterochtend
gitaarspeler|gitarist
gladheid|glibberigheid|sluwheid
gladjanus|gluiperd
gladstrijken|strijken
glans|gloed|schijn|schijnsel
glansrijk|glinsterend|schitterend|mooi
glasachtig|glazig|uitdrukkingsloos
glasblazerij|glasfabriek
glasgordijn|vitrage
glashelder|kristalhelder
glasschilder|glazenier
glasservies|glaswerk
glazig|leeg|nietszeggend|uitdrukkingsloos
glazuur|verglaassel
gleuf|kier|sleuf|opening
glibberen|glijden|glippen|roetsjen|wegglippen
glijbaan|glijplank|roetsjbaan
glijden|roetsjen
glimlachen|grijnzen|grimassen
glimp|vleugje
glinsterend|schitterend
glinstering|vonk
glippen|wegglippen
globaal|ruwweg
gloed|hitte|warmte
gloeien|nasmeulen
gloeilamp|peer
glorietijd|hoogtijdagen
glorieus|trots
glorificatie|verering|verheerlijking
gniffelen|grinniken|proesten
gnoom|kabouter|kobold
God|aker|heer|godheid|maker|heerser|schepper
goddelijkheid|godheid
godgeleerd|theologisch
godsdienstige|religieuze
godsdienstoefening|godsdienstplechtigheid
godsvrucht|godvruchtigheid|vroomheid
godswoningen|kerken
godvruchtigheid|vroomheid
goed|inderdaad|juist|terdege|was|ja|wasgoed
goedaardig|hartelijk|hulpvaardig|vriendelijk
goedbedoeld|welgemeend
goeddeels|grotendeels|hoofdzakelijk|merendeels|overwegend
goedemorgen|goeiemorgen
goederen|handel|handelsgoederen|koophandel|have|koopwaar
goederenhandel|handel|markt
goederentransport|goederenverkeer
goederenvoorraad|voorraad
goedgeefs|rijkelijk|scheutig|vrijgevig
goedgeefsheid|royaliteit
goedgunstigheid|gratie|welwillendheid
goedhartig|zachtmoedig|zachtzinnig
goedje|materiaal|spul|spullen
goedkeuren|instemmen
goedkeurend|instemmend
goedwillendheid|welwillendheid
goedzak|goeierd
golf|golving|vloedgolf|roller
gonzen|zoemen
gooi|werp
gooien|jongen|slingeren|werpen
gordijn|voorhang
gort|gortenpap
gouddelver|goudzoeker
gouden|goudkleurig|gulden|vergulde
goudkleurig|gulden|piek
goudvink|vink
gourmet|lekkerbek|smulpaap|snoeperd
gouvernante|kinderjuffrouw
gouverneur|landvoogd|regent|stadhouder
gozer|kerel|manspersoon|vent
graadmeetapparaat|graadmeter|indicator
graadmeter|indicator
graaf|landgraaf
graafwerk|grondwerk
graaien|rechercheren|snuffelen|rondwroeten
graanpakhuis|graansilo
graansoort|tarwe
gracht|kanaal|singel|stadsgracht|vaart
grachtenhuis|grachtenpand
gradaties|graderingen|niveaus
grafgewelf|grafkelder|graftombe
grafiek|prentkunst
grafkelder|graftombe
grafrede|lijkrede
grafsteen|grafzerk
grammatica|spraakkunst|spraakleer
grammofoon|platenspeler|schijf
grandeur|indrukwekkendheid
graniet|hardsteen
grapjes|lolletjes|moppen|schertsen
grappenmaker|komiek|olijkerd|potsenmaker|paljas
grappig|hilarisch|humoristisch|koddig|lollig|komisch
grappigheid|vermakelijkheid|vertier
gras|grasmat
grashalm|grasspriet
grasland|weide|weiland
grasmaaier|grasmaaimachine
graszode|zode
gratis|kosteloos
graven|opgraven|scheppen
gravin|landgravin
gravitatie|zwaartekracht
grazen|weiden|weilanden
greep|handel|handgreep|kolf|handvat
grein|korrel
greintje|zweem
grendelen|vergrendelen
greneboom|sparreboom|sparrenboom
grenen|grenenhout
grens|grenswaarde|landgrens|limiet|grenzeloos|rijksgrens|uiterste|landsgrens
grensgebied|grensstreek|randgebied
grenslijn|lijn|limiet|schreef|streep
grenzeloos|onbeperkt
grenzen|limieten
gretig|happig
grienen|huilen|snikken|snotteren
griep|influenza
griepen|klieren|plassen|zeiken|talmen
grievend|kwetsend
griffie|kanselarij
grijns|grimas|sneer
grijnzen|grimassen
grijpen|jatten|toeslaan|verstrikken|pikken|wegkapen
grijs|grijsharig
gril|nuk
grillig|onberekenbaar|wispelturig|onvoorspelbaar
grilligheid|wispelturigheid
grimmig|haatdragend|verbeten|onderdrukt
grind|grindsteen|kiezelsteentjes
grindsteen|kiezelsteentjes
grinniken|niezen|proesten
grip|houvast
groen|groenkleurig
groenteboer|groenteman
groentensoep|groentesoep
groententuin|groentetuin
groentetuin|moestuin
groep|menigte
groeperen|indelen|scharen
groepsactie|groepsactiviteit
groet|handgebaar
groeve|steengroeve
groeven|inkerven
grof|korrelig|ordinair|schunnig|plat|vulgair
grofheid|schofterigheid
grond|onderbouwing|vloer
grondbeginsel|hoeksteen|sluitsteen
grondbestanddeel|hoofdbestanddeel
grondbezitter|landheer
grondeloos|onbevattelijk|onpeilbaar
grondgedachte|hoofdgedachte|uitgangspunt
grondlegger|oprichter|oprichtster|stamvader|stichter
grondplan|plan|plattegrond
grondstelling|hoofdstelling
grondwaterspiegel|grondwaterstand
grondwettelijk|staatsrechtelijk
groot|vitaal
grootbrengen|opvoeden|vormen
groothandel|groothandelaar|grossier|grossierderij
groothandelaar|grossier
grootheidswaan|grootheidswaanzin
grootmoeder|oma
groots|ruim|weids
grootspreken|opscheppen|snoeven
grootspreker|opschepper
grootst|uiterst
grootte|inhoud|ruimte|volume|uitgebreidheid|uitgestrektheid|universum
grootvader|opa
grot|hol|spelonk
grote|omvangrijke|uitgestrekte|volwassene
gruis|metselspecie|steengruis
gruwel|gruweldaad|wandaad|watergruwel|wreedheid
gruweldaad|wandaad
gruwelijk|ontzettend|schrikaanjagend|vreselijk
guirlande|slinger|zwengel
guitig|olijk|ondeugend|schalks
guitigheid|kwajongen|ondeugd
gunnen|toebedelen|toekennen|toestaan|toewijzen
gunstige|veelbelovende
guur|kil
gymnastiekvereniging|sportclub
gymschoen|sportschoen
gymschoenen|sportschoenen
ha|hectare
haag|heg|liguster
haaibaai|heks|helleveeg|kuttenkop|teef|viswijf|toverkol|loeder|wijfjeshond
haaienvin|haaievin
haak|ophanghaak|tekenhaak
haakje|ophanghaakje
haaks|loodrecht|rechthoekig
haal|kras|ruk|trek
haalbaar|realiseerbaar|verwezenlijkbaar
haarbos|haardos
haarbuisje|haarvat
haard|haardstede|stookplaats|vuurhaard
haardoek|hoofddoek|tulband
haardracht|pony
haardstede|stookplaats
haardstok|pook|versnellingshandel
haarkloven|muggenziften|muggeziften
haarklover|muggenzifter
haarkrul|krul|krulvorm|urinoir
haarkuif|hanenkam|kuif
haarlak|haarversteviger
haarvlecht|vlecht|wrong
haarvlechten|ineenvlechten|vlechten
haast|haastigheid|ijl|spoed
haastigheid|ijl|snelheid|topsnelheid|spoed
haatdragend|rancuneus|verbeten|wraakzuchtig
haatdragendheid|rancune
hachee|prak
hagel|hagelsteen
hagelbui|hagelvlaag
hak|hiel
haken|tekenhaken
hakkelen|haperen|stotteren|stamelen
hal|ontvangstruimte|ridderzaal|vishal|salon
halfcirkelvormig|halfrond|hemisfeer
halfdonker|schemer|schemerdonker|schemering
halfgaar|halfzacht
halfjaar|semester
halfrond|hemisfeer
hallo|hoi
hallucinatie|zinsbegoocheling
halm|steel|stengel
hals|keel|nek|keelgat
halsband|leiband
halsbontje|lamsvacht|pels|vacht
halsdoek|omslagdoek|shawl|sjaal
halskraag|kraag
halte|station|stopplaats|treinstation
halthouden|stoppen
hamer|slaghamer
hamsteren|oppotten|potten
handel|handeldrijven|negotie|handelsverkeer|koophandel|koopwaar
handelaar|handelsreiziger|koopman|verkoper|winkelbediende
handelaren|kooplieden
handeldrijven|koopwaar|nering|winkelbedrijf
handelsartikel|handelsproduct
handelsmerk|handelsnaam|label|merk|sticker|merknaam|merkteken
handelsreiziger|verkoper|vertegenwoordiger
handelsscheepvaart|koopvaardij
handelsvertegenwoordiger|vertegenwoordiger
handgreep|handvat
handkar|handwagen
handlanger|medeplichtige|trawant
handreiking|hulpbetoon
handschoen|omdat|want
handwortel|pols
hanebalk|hanenbalk
hanekam|hanenkam|kuif
hanenpoot|hanepoot
hangconstructie|hangwerk
hangen|zweven
hanger|klerenhanger|knaapje
hansworst|kwibus
haperen|stokken|stotteren|vastlopen|wandelstokken
hapje|snack|tussendoortje|versnapering
happen|toebijten
harden|stalen|uitharden|trainen|verharden
hardheid|kalkgehalte
hardhorend|slechthorend
hardloopwedstrijd|loop
hardlopen|rennen
hardnekkigheid|stijfkoppigheid
hardsolderen|solderen
hardvochtig|harteloos|onbegaan|zielloos|ongevoelig|onverschillig
haring|pin|tentharing
harmonie|samenklank
harmonieus|melodieus|welluidend
hartaandoening|hartafwijking|hartziekte
hartaanval|hartinfarct|myocardinfarct
hartelijk|vriendelijk
hartelijkheid|jovialiteit|vriendschappelijkheid
hartenwens|hartewens
hartslag|polsslag
hartstochtelijk|heetbloedig|stormachtig|temperamentvol|warmbloedig|heetgebakerd|heethoofdig
hasj|hasjiesj|hennep|wiet
hasjiesj|hennep|marihuana|wiet
hatelijk|stekelig|vijandelijk|vijandig
haven|toevluchthaven
havendam|pier|regenworm
havengeld|liggeld
havenmeester|havenopzichter
havermout|havervlokken
hebberig|hebzuchtig|inhalig|vrekkig
hechtheid|stevigheid|vastheid
hechting|vasthechting
hechtpleister|pleister|stuc
heden|vandaag
hedenavond|vanavond
heel|intact
heelal|ruimte|universum
heelhuids|ongedeerd|ongeschonden
heer|heerser|monarch|soeverein
heerschaar|legerschaar
heerschap|sujet|vent
heersend|regerend
heerser|koning|majesteit|monarch|soeverein|vorst
hees|schor
heesheid|schorheid
heester|struik
heesters|struiken|struikgewas
heetbloedig|heetgebakerd|heethoofdig|prikkelbaar
heftig|onbedaarlijk|onbeheerst|onstuimig
heftruck|vorkheftruck
heg|liguster
heggenschaar|heggeschaar
hei|heide|heidecultuur|heidegrond
heide|heidecultuur|heidegrond
heiden|ongelovige
heidendom|paganisme
heiigheid|mist|waas|zweem
heildronk|toost
heiligen|inwijden|inzegenen|zegenen
heiligenschijn|stralenkrans
heilloos|rampspoedig|verderfelijk|verdorven
heilstaat|utopie
heilzaam|zegenrijk
heimelijk|onderhands|stiekem|stilletjes
heining|muur
heisa|rompslomp
hek|hekwerk|rasterwerk
hekeldicht|satire|spotdicht
hekkensluiter|laatste
heks|toverkol
heksenverbranding|ketterverbranding
hekwerk|rasterwerk
heldenmoed|moed
helderheid|lichtsterkte
heldhaftig|kloek|onbeschroomd|onversaagd|stout|onvervaard|onverschrokken|stoutmoedig
helft|tweede
hellevuur|vagevuur
helling|talud
hellingsgraad|hellingshoek
helm|hoofdbescherming
helmpluim|pluim|veer
helpen|promoten
hemd|onderhemd
hemelkoepel|zwerk
hemelvaart|hemelvaartsdag
hen|hoen|hun|kip
hengel|vishengel
hengelen|hengelsport|vissen|visvangen
hengelsport|vissen
hennep|marihuana|weed|wiet
her|hier
herbenoemen|herplaatsen
herberg|hotel|logement|onderdak
herbergen|onderbrengen
herbergier|kastelein|waard
herbouw|reconstructie
herbouwing|restauratie
herder|veehoeder
herderin|schaapherderin
herdershut|hut|hutje|kajuit
hereniging|reunie|weerzien
herenkleding|herenmode
herenkostuum|pak
herfst|najaar
herfstmaand|september
hergebruik|herwinning|recirculatie|recuperatie
herhaaldelijk|telkens|veelvuldig|voortdurend
herhalen|napraten|nazeggen|oefenen|repeteren
herhaling|heruitzending|repetitie
herinnering|herrinnering|heugenis
herkennen|thuisbrengen|waarnemen
herkrijgen|hervinden|herwinnen|terugbekomen|terugkrijgen
herleiden|terugvoeren
herleiding|vereenvoudiging
hermetisch|luchtdicht
herrie|lawaai
herroepen|terugnemen
herroeping|intrekking
herschatting|herwaardering
hersenbreker|probleem|puzzel
hersenschimmen|verbeeldingen
herstel|herstelling|reparatie
herstellen|repareren
hersteller|reparateur
herstelling|substitutie|surrogaat|vervanging
herstelwerkzaamheden|restauratie
hertebok|kinderspeeltje|rammelaar
hervinden|terugvinden
hervormen|veranderen
herwaarderen|opwaardering
herwinning|terugkrijgen
het|ie
hetzelfde|idem
heugelijk|heuglijk|verblijdend
heuglijk|verblijdend
heupjicht|ischias
heus|kloppend|ongetwijfeld|warempel|koopwaar|waar|waarachtig
heuvelland|heuvellandschap
hevel|houtvlotter|vlotter
hevig|innig|naarstig|intens|verwoed|intensief
hierom|hiertoe
hijgen|puffen
hijsarm|lichter
hijsblok|katrol|takel
hijsen|ophijsen
hijsinstallatie|hijskraan
hinder|last|ongemak
hinderlaag|teloorgang|val|valstrik|terechtkomen
hinderlijk|lastig|onaangenaam|storend
hindernis|hinderpaal
hinkelen|hinken
hit|kasstuk|klapper|succesnummer
hitlijst|hitparade
hitte|warmte
hobbel|hobbeligheid|ongelijkheid|oneffenheid
hobbelig|oneffen|ongelijkmatig
hobbeligheid|oneffenheid
hoeder|schapenhoeder
hoef|hoornschoen
hoefbeslag|hoefijzer
hoefgetrappel|hoefslag
hoefsmid|smid
hoekig|kantig
hoekje|schuilhoekje
hoeksteen|sluitsteen
hoenderhok|kippenhok|ren|kippenren
hoepla|hopla
hoer|hoertje|prostituee
hoereerder|hoereloper|hoerenloper
hoeren|hoereren
hoes|platenhoes
hoest|hoestaanval
hoeveelheden|porties
hoeven|paardenhoeven
hofje|patio
hofnar|kwibus|nar
hogedrukpan|snelkookpan
hok|hut|hutje
hol|inhoudsloos|nietszeggend|leeg|spelonk
holheid|leegheid
Holland|Nederland
Hollander|Nederlander
hollands|nederlands
holte|muurnis|nis
home|huis
homofilie|homoseksualiteit
homoloog|overeenstemmend
homoseksueel|nicht
homp|vod
hondenliefhebber|kynoloog
hondenweer|rotweer
honderd|honderdtal
honen|verguizen
honger|zucht
hongerlijden|verhongeren
honingdrank|mede
honingraat|raat
honingzoet|mierzoet
honk|huis|verblijf|woning
honorarium|salaris
hoofd|hoofdeinde|opperhoofd|rector|kop|stamhoofd|schoolhoofd
hoofdagent|hoofdvertegenwoordiger
hoofdbedekking|hoofddeksel|hoofdtooi
hoofdbeginsel|principe
hoofdboek|klapper
hoofddoek|tulband
hoofden|koppen
hoofdkantoor|hoofdkwartier|hoofdzetel|hoofdvestiging
hoofdkussen|kussen|zoenen
hoofdkwartier|hoofdzetel
hoofdpersonage|hoofdpersoon|hoofdrolspeler
hoofdpijn|koppijn|migraine
hoofdrol|titelrol
hoofdstuk|kapittel
hoofdvestiging|hoofdzetel
hoofdweg|voorrangsweg
hoofdzakelijk|overwegend|voornamelijk|vooral
hoog|hooggelegen|schel
hoogachten|respecteren
hoogbejaard|stokoud
hoogmoedigheid|trots
hoogspringen|hoogtesprong|sprong
hoogstandje|stunt
hoogste|opperste|voornaamst
hoogtelijn|niveaulijn
hoogtepunt|record
hoogtesprong|sprong|stijging
hoogteverschil|niveauverschil
hoogwater|vloed
hooikar|hooiwagen
hooiland|hooiveld
hooimaand|juli
hoop|opeenhoping|opeenstapeling|stapel
hoor|horen|waarnemen
hoorn|jachthoorns
hopeloos|kansloos|uitzichtloos
horeca|horecasector
horrelvoet|klompvoet
horticultuur|tuinbouw
hospes|huisbaas|kamerverhuurder
hospitaal|ziekenhuis
hotelsuite|suite
houd|vasthouden
houdbaar|verdedigbaar
houden|liefhebben|vasthouden
houder|penhouder
houtbrij|pulp
houterig|stijf|stram|stroef
houthakker|houtkapper
houtspaander|roeispaan|spaan
houtvlot|vlot
houtvlotter|vlotter
houtwerk|timmerwerk
houtwerker|schrijnwerker|timmerman
houtzagerij|zagerij
houvast|ondersteuning|ton|steun|vat
hovenier|tuinier|tuinman
hozen|leeghozen|uithoren
huichelaar|hypocriet
huid|vel
huidje|laagje
huidkleur|inkarnaat|vleeskleur
huidrimpel|lijn|rimpel|riem|schreef|spoorlijn
huidskleur|teint
huidsmeer|talg
huiduitslag|uitslag
huidvet|liposoom
huifkar|huifwagen
huilen|krijsen|schreien|wenen|schreeuwen
huis|stulp
huis-aan-huis-verkopen|leuren|venten
huisafval|vuilnis
huisbaas|kamerverhuurder
huisbewoner|inwoner
huishouden|huishouding
huishuur|huur|huursom|huurprijs
huisjesslak|metaalslak|slak|treuzelaar
huiskamer|woonkamer|zitkamer
huisleraar|repetitor
huisraad|inboedel
huisschilder|schilder
huisschilders|schilders|ververs
huissloof|moeke
huisvesting|kwartier|tehuis
huisvuil|vuilnis
huiswerk|schoolwerk
huivering|rilling
huizehoog|torenhoog
huizen|woningens
huizenmakelaar|makelaar
hulde|verering
huldigen|onderscheiden
hulp|poetsvrouw|schoonmaakster|werkster
hulpbehoevendheid|nood
hulpbetoon|hulpverlening
hulpdienst|nooddienst
hulpeloos|weerloos
hulpje|knecht
hulpmiddel|redmiddel
hulppriester|kapelaan
hulpverlener|opbouwwerker
huls|omhulsel|patroon
humanitair|menselijk
humoristisch|komisch
huur|huursom
huurprijs|huursom
huwelijksceremonie|huwelijksplechtigheid
huwen|trouwen
hypergevoelig|overgevoelig
hypothecaris|hypotheekhouder
hypotheek|kredietverlening|lening
hypothese|veronderstelling
hypothetisch|imaginair
icoon|voorbeeldfiguur
identiteitsbewijs|legitimatie|legitimatiebewijs|pas|paspoort|persoonsbewijs
idioom|taaleigen
idyllisch|sprookjesachtig
iel|teer
iep|olm
ijdel|leeg|nutteloos|onbeduidend|ongevuld|loos|tevergeefs|onvruchtbaarheid|vergeefs|vruchteloos
ijdelheid|ijdeltuiterij|zelfingenomenheid
ijk|ijking|ijkmerk
ijkmerken|waarmerken
ijl|topsnelheid
ijsbeer|poolbeer
ijsblok|ijsblokje
ijsje|roomijs
ijskast|koelkast
ijskasten|koelkasten
ijskegel|pegel
ijskoud|ijzig|stervenskoud|koud
ijswater|smeltwater
ijveren|streven
ijverig|vlijtig
ijzergaas|kippengaas
ijzerhandel|ijzerwinkel
ikzelf|zelf|zelve
illegaal|ongeoorloofd|onwettig|wederrechtelijk
illusie|waan|waandenkbeeld
illustratie|tekening
illustraties|plaatjes
imaginair|ingebeeld|schoolmeesterachtig|zelfingenomen
imiteren|nabootsen|navolgen|nadoen
immens|kolossaal|levensgroot|onmetelijk|reusachtig
immer|immermeer
immers|namelijk
immoreel|oneerbaar|onzedelijk|verdorven
immuun|onschendbaar
imploderen|ineenstorten|instorten
import|invoer
importeren|invoeren
importeur|invoerder
imposant|indrukwekkend|overdonderend|ontzagwekkend|overweldigend
impotentie|krachteloosheid|onmacht
impressie|indruk
in|te|ter
inbegrepen|inclusief|ingesloten|met|omsingeld
inboedel|inventaris
inboezemen|ingeven|inspireren
inboorling|inlander
inborst|inslag|temperament
inbraak|kraak
inbrengen|invoegen
inbrenger|inlegger|spaarder
inbreuk|schending|schennis
incalculeren|verdisconteren
incasseerbaar|opeisbaar|opvorderbaar
incasseren|innen
incasso|innen|invordering|vordering
incidenteel|soms|sporadisch|weleens|somwijlen|zelden
inclusief|met
inconsistent|onbestendig|veranderlijk
incorporeren|inlijven
indelen|systematiseren
indeling|rangschikking
inderdaad|ja|jawel|waarachtig|wel|waarempel|jazeker|waarlijk|zowaar
indicatie|schatting
indiening|presentatie
indigestie|spijsverteringsstoornissen
indirect|officieus|zijdelings
individu|persoon
indommelen|wegzakken
indompelen|indopen
indraaien|inschroeven
indringer|insluiper
indrukwekkend|majestueus|parmantig|plechtig|plechtstatig|statig
ineens|opeens|plots|plotseling|plotsklaps|spontaan
ineenstorten|instorten
ineenstrengelen|verstrengelen
ineenvlechten|strengelen|vlechten
inenten|inoculeren
inenting|vaccin|vaccinatie
infanterie|voetvolk
infantiel|kinderachtig|kinderlijk
infecteren|vergiftigen|vergiftiging|verpesten
infectie|ontsteking|ziekte
inferieur|ondergeschikte|ondermaats|onvolgroeid
infiltrant|spion
influisteren|ingeven|souffleren
info|informatie
informant|tipgever
informatie|inlichting|kennisgeving|kennisoverdracht|verwittiging
informatief|leerrijk|leerzaam
informerend|navragend
infrastructuur|wegennet
ingebeeld|pedant|schoolmeesterachtig|verwaand
ingeblikt|ingemaakt
ingebouwd|ingebouwde
ingediend|voorgelegd
ingekeken|ingezien
ingekort|verkort
ingelast|ingevoegd
ingenieus|kunstig
ingesloten|omsingeld
ingespannen|verdiept
ingetogenheid|onbevlektheid|zedigheid
ingevuld|invullen|invulling
ingooi|inworp
inhouden|omvat|omvatten
inhoudsloos|ledig|leeg|nietszeggend
inhuldiging|inwijding|inzegening
initialen|parafering
initiatie|inwijding
initiatiefnemer|veroorzaker
injecteren|spuiten|uitspuiten
injectie|prik|spuitje
injectienaald|injectiespuit|spuit
injectiespuit|spuit
inkarnaat|vleeskleur
inkepen|kerven
inkeping|inkerving|jaap|kartel|metselspecie|reet|snede|tussenruimte|keep|karteling|split|snijwond|uitsparing|kerf|syndicaat|steengruis
inkerving|keep|kerf
inkijken|inzien
inklappen|opvouwen|vouwen
inklaren|inklaring|klaren
inkopen|inslaan|winkelen
inkorten|korten
inkorting|inname
inkrimpen|krimpen|slinken|verminderen
inktstempel|plakzegel|stempel|spaarzegel|zegel
inladen|laden
inlassing|las|tussenvoegsel
inleg|inlegsel
inleggen|invoegen
inlegger|spaarder
inlegkapitaal|investering
inleidend|voorafgaand|voorgaand
inleiding|introductie|proloog|voorbericht
inleven|invoelen|meeleven|voel
inlichten|voorlichten
inlichtingen|tips|toelichtingen
inlichtingendienst|spionagedienst
inmaken|inpekelen|wecken
inmanen|invorderen|opeisen|vorderen
inmiddels|tijdelijk|tussentijds
innen|invordering
innovatie|innovation|vernieuwing
innoverend|vernieuwend
inpakken|inpalmen|inwikkelen|verpakken
inpakpapier|verpakkingspapier
inpeperen|inwrijven
inpikken|ontvreemden|pikken|stelen
inpoldering|winning
inrit|oprijlaan|oprit
inruil|omruiling|ruil|uitwisseling
inruilbaar|inwisselbaar|wisselbaar
inscheuren|scheuren
inschoppen|intrappen
inschrijfgeld|inschrijfkosten
inschrijving|registratie
inslaan|stukslaan
insluiten|omcirkelen|omsingelen|omsluiten
insluiting|omsingeling
insolventie|machteloosheid|onvermogen
inspanning|inzet
inspraak|medezeggenschap
inspreken|opnemen
instellen|klaarmaken
instigeren|opwekken
instoppen|toedekken
instorting|neervallen
instructeur|leermeester|opleider|leraar|mentor
instructie|orde|regel|voorschrift
instrument|muziekinstrument
instrumenteren|orkestreren
instuderen|leren
insturen|inzenden
integer|oprecht|rechtschapen
integraal|volledig
integreren|samenvoegen
intekening|subscriptie
intelligent|slim
intelligentie|pienterheid|slimheid
intendant|kwartiermaker|kwartiermeester
intens|intensief
intensiteit|kracht|sterkte
intensiveren|toespitsen|verhevigen
intensivering|verdieping
interest|rente
interlinie|regelafstand
intern|inwendig
internaat|kostschool
interne|inwonende
interpellant|rekwestrant|vrager
interpellatie|vraag
interpretatie|lezing
interpreteren|omzetten|vertalen|overbrengen|overzetten
interventie|tussenkomst
interview|vraaggesprek
intiem|vertrouwelijk
intikken|intoetsen|intypen
intimidatie|vreesaanjaging
intimideren|ringeloren|terroriseren
intimiteit|vertrouwelijkheid
intocht|komst
intoetsen|intypen
intonatie|stembuiging
intrigant|kuiper|stoker|stokebrand|tweedrachtzaaier
intrige|konkelarij|plot
intrigeren|konkelen
intriges|plotten|verwikkelingen
introduceren|proposities|voorslaan|voorstellen
introductie|invoering|proloog
invaliden|mindervaliden
invaller|noodhulp|wissel|wisselspeler
inventiviteit|vindingrijkheid
invetten|oli|smeren|vertrekken
invloed|stem|stemkracht|zeggenschap
invloedrijk|vooraanstaand
invoelen|medeleven|meeleven|meevoelen
invrijheidstellen|loslaten|vrijlaten
invullen|invulling
inweken|weken
inwijden|inzegenen
inwikkelen|verpakken
inwilligen|toestaan|vergunnen
inwisselen|omruilen|uitwisselen|omwisselen|ruilen|verruilen|omwisseling
inzaaien|zaaien
inzegenen|zegen|zegenen
inzetbaar|toepasbaar
inzetten|verwedden|wedden
inzittende|passagier|reiziger
irritatie|kriebels
irriterend|prikkelend
issue|kwestie|punt
item|voorwerp
jaagpad|landweg|paadje|pad|padachtige|schildpad
jaar|klas|schooljaar
jaargetijde|seizoen
jaarlijks|jaarlijkse
jaarloon|jaarsalaris
jacht|jachtpartij|jagen
jachtliefhebber|jager
jacquet|pandjesjas
jaggernaut|moloch
jaknikken|knikken
jammer|onbevredigend|sneu|spijtig
jammeren|weeklagen
jammerend|jeremi
jargon|vaktaal
jas|jasje|jekker|mantel|overjas
jassen|pellen|schillen
jatten|stelen
jawel|waterput|wel|welnu
je|jij|jou|jouw
jeneverbes|jeneverbessestruik|jeneverbessevrucht|jeneverbesstruik
jeneverbessestruik|jeneverbesstruik
jeugd|jeugdigheid|jongelui|kindertijd
jeugdig|jong|welp
jeugdliefde|kalverliefde
jeuk|jeukerigheid|kriebel
jeukerigheid|kriebel
jochie|knul
jodium|jodiumtinctuur|jood
joelen|uitjouwen
joetje|tientje
jogger|korteafstandloper|loper|renner|sprinter|wielrenner
joghurt|yoghurt
joint|snaak
jokeren|kaarten|pandoeren|rikken
jokken|liegen
jolig|uitbundig|uitgelaten|vrolijk
jong|welp
jongedame|meisje
jongen|rakker|werpen
jongere|junior
jongste|laatstgeborene
journaal|nieuws|nieuwsjournaal|nieuwsbericht|televisiejournaal|webpagina
journalist|reporter|verslaggever
journaliste|verslaggeefster
juf|juffrouw|schooljuffrouw|onderwijzeres
juffrouw|mejuffrouw|schooljuffrouw
juist|kloppend|zojuist|precies|uitgerekend|zonet|zo
juistheid|stiptheid
jungle|oerwoud
jurisdictie|rechtsbevoegdheid|rechtsgebied
jurist|pleiter
jus|saus|vruchtensap
juskom|sauskom
justitieel|rechterlijk
juut|politieman
juweel|sieraad|sierstuk
juwelen|sieraden
kaai|kade
kaak|schandpaal|scheepsbeschuit
kaal|onbehaard|onherbergzaam|ruig|steriel
kaalkop|kale
kaapstander|spil
kaarsenstandaard|kandelaar|kandelaber
kaarsrecht|lijnrecht|loodrecht|recht|verticaal
kaart|kaartje|landkaart|speelkaart|ticket|toegangsbewijs
kaarten|kaartspel
kaartje|toegangsbewijs
kaartjeskniptang|kniptang
kaasstremsel|stremsel
kabinet|kabinetkast|regering
kachel|verwarming
kadaster|kadasterbureau
kadaver|lijk
kaderlid|staflid
kak|poep|schijt|stront
kalebas|pompoen
kali|kalium
kalkoen|kalkoenvlees
kalm|kalmpjes|relaxed|sereen|vrij
kalmte|rust|vredigheid
kamer|ruimte
kameraadschap|vriendschap
kamerjas|ochtendjas|peignoir
kamers|vertrekken
kamerwand|wand
kampanje|scheepskampanje
kampioen|titelhouder|winnaar
kampioene|winnares
kampplaats|strijdperk
kampvechter|ruziemaker|vechter
kamwiel|kettingrad|kettingwiel
kamwielen|kettingwielen
kan|schenkkan|vermag
Kanaal|Nauw van Calais|vaart
kandelaar|kandelaber|luchter
kandelaber|luchter
kandidaat-notaris|kandidaatnotaris
kandidaatsstelling|kandidatuur
kankeren|zeuren
kannibaal|menseneter
kanovaren|kano
kans|mogelijkheid|waarschijnlijkheid
kansberekening|kansrekening
kansel|preekstoel
kansloos|uitzichtloos
kant|kantkloswerk|ze|zij|zijde|zijkant
kantelen|wentelen
kantlijn|marge
kantoor|kantoorgebouw|werkplek
kantoortijden|kantooruren|werktijden
kantooruren|werktijd|werktijden
kapellen|muziekgezelschappen
kapen|stelen
kaper|piraat|zeerover
kapitein|scheepsgezagvoerder|schipper
kapotmaken|moeren|mollen
kapotslaan|stukslaan
kappen|stoppen
kapper|kappertjesstruik
karakter|letter|letterteken
karakteriseren|kenschetsen|typeren
karakteristiek|kenmerkend|kenschetsend|tekenend|typerend
karakterloos|slap
karakters|letters
karaktertrek|stigma
karaktertrekje|trekje
karbonade|kotelet
karig|pover
karigheid|schamelheid|schraalheid
karikatuur|spotprent
karmijn|karmijnrood
karpet|tapijt|vloerkleed
karren|kruien|rijden
karretje|wagentje
kartel|karteling|syndicaat
karwei|klus
karweitje|klusje
kas|kassa
kassier|penningmeester
kasstuk|kassucces|succesnummer
kast|kastje
kastanje|kastanjeboom
kastanjebomen|kastanjes
kasteel|slot
kastelein|kroeghouder|slotvoogd
kastijden|tuchtigen
katholiek|rooms
katoen|katoengaren|katoenstof
kattebak|kattenbak
kattekwaad|kattenkwaad
kattenstaart|kattestaart
kauw|rouck
keel|keelgat
keelgat|strot
keerdam|stuw|stuwdam|waterkering
keerzang|refrein
keerzijde|ommezijde|schaduwzijde
keg|keil|wig
kegelvormig|taps
kei|rolsteen|slimmerd|steen
keihard|oorverdovend|steenhard
keil|wig
kelderen|steekzakken|tuimelen|tassen|zakken
kelkenbakje|mat|onderzetter|matje
kelner|ober|tafelbediende
kelnerin|serveerster
ken|kennen|weten
kennelijk|ogenschijnlijk|schijnbaar
kennen|kennis|weten
kennisgeven|kennisgeving
kennismaken|ontmoeten
kennismaking|ontmoeting
kenschetsend|typerend
kent|weet|weten|wetenschap
kenteken|merkteken|nummerplaat
kentering|ommekeer|omwenteling
keper|keperstof
keramiek|pottenbakkerskunst
kerel|man|manspersoon|men|vent
kerels|mannen
keren|omdraaien|omkeren|wenden
kering|omkering
kerkelijk|kerksgezind
kerkgebruik|rite
kerkgezang|kerkzang
kerkuil|torenuil
kerseboom|kersenboom
kerstversiering|piek
ketel|kookketel
keten|ketting|winkelketen
keuken|kookplaats
keukendoek|theedoek|theedoeken
keukengerei|keukenuitrusting
keukenmeid|keukenprinses|meid
keurig|voorbeeldig
keurigheid|netheid|onberispelijkheid|ordelijkheid
keurmerk|keurstempel
keurslijf|korset
keus|optie
keuze|preferentie|verkiezing|smaak|voorkeur|voorliefde
kever|tor
kidnappen|ontvoeren
kidnapper|ontvoerder
kiem|zaad
kiepen|tuimelen
kier|sleuf
kies|tactvol
kiesdistrict|stemdistrict
kiesgerechtigde|kiesman
kieskeurig|selectief
kiespijn|tandpijn
kiesrecht|stemrecht
kiezel|kiezelsteen
kiezen|schiften|selecteren|uitzoeken
kiezer|stemmer
kijken|loeren
kijker|oog|televisiekijker|verrekijker
kijkers|ogen
kikker|kikvors
kil|koeltjes
kilometerteller|snelheidsmeter
kind|kleintje|kleuter|zuigeling
kinderbad|pierebad
kinderbed|kinderledikantje
kinderen|koters|nageslacht
kinderkamer|speelkamer|speelruimte
kinderoppas|oppas
kinderopvang|peuterspeelplaats
kinderspeeltje|rammelaar
kippenboutje|kippenpoot
kippenhok|kippenren
kippensoep|kippesoep
kippenvel|kippevel
kirren|koeren
kist|krat
kistjes|schoeisel|schoenen|schrijnen
kit|kleefstof|kolenkit|lijm|plak
klaaglied|treurzang
klaarblijkelijk|onmiskenbaar|overduidelijk
klaarleggen|klaarzetten
klad|proefversie
klagen|zeuren
klakken|kleppen
klamp|klamplaag|mijt
klandizie|klantenkring
klankkleur|kleur
klankweerkaatsing|resonantie
klantenkaart|klantenpas
klap|opstopper|peut|stoot
klaplopen|parasiteren
klaploper|parasiet|uitvreter|profiteur
klaplopers|profiteurs
klappen|knallen|vuistslagen|smakken
klapper|knalbonbon|telefoonklapper|zevenklapper
klapstoel|vouwstoel
klas|schooljaar|schoolklas
klasse|levensstijl|stijl|tralie
klassement|klassering
klassen|schoolklassen
klaverblad|verkeersplein
klavier|piano
kledder|klodder|lik
kleding|kleren
kledingwinkel|kledingzaak
kleedhokje|kleedkamer|pashokje|paskamer
kleefstof|lijm
kleerhanger|klerenhanger|knaapje
kleermaker|tailleur
kleermakerskrijt|speksteen
klef|kleverig|plakkerig
klei|leem
kleingeestig|kleinzielig
kleingeld|wisselgeld
kleinigheid|snuisterij
kleinste|miniemste
klem|klemhaak|pen|tang|pin|speld
klemmen|knellen|omklemmen|vasthouden
klemzitten|vastzitten
klep|kletskous|kwebbel|kletsmajoor
kletserig|loslippig|spraakzaam
kletskoek|kolder|wambuis
kletskous|kletstante|kwebbel
kletsmajoor|kwebbel
kletteren|rammelen
kleuren|tinten
kleurenspel|schakering
kleurling|neger|zwarte|nikker
kleurrijk|veelkleurig
kleurschakering|nuance|tint
kleurstof|pigment
kleven|plakken
kleverig|plakkerig
klieven|kloven|splijten
klimaat|weer|weersgesteldheid|weersomstandigheden
klimmen|opstijgen|stijgen|stijging
klimmend|oplopend|opstijgend|toenemend|stijgend
klingelen|rinkelen|tingelen
klinkbout|klinknagel|spijker
klinken|spijkeren|vastklinken|timmeren|vastslaan
klinker|vocaal
klinknagel|nagel|spijker
klip|obstakel
klitteband|klittenband
klodder|lik|strafgevangenis
klok|pendule|uurwerk
klokje|polshorloge
klokken|tijdmeten
klokluiden|luiden
klont|klonter
klontertje|klontje|suikerklontje
klontje|suikerklontje
klooster|kloostergebouw|nonnenklooster
kloosterzuster|non
kloppen|lillen|trillen
kloten|testikels
kluiven|knagen|knauwen
klungel|kruk|stakker|stumper|sukkel
klungelen|knoeien
klus|klussen
knabbelen|peuzelen
knagen|knauwen
knak|knik|strubbeling
knallen|neerkwakken|smakken
knalpotten|uitlaten
knap|slim
knapzak|ransel
knechten|knevelen|onderdrukken|onderwerpen
kneden|vormen
kneedbaar|vormbaar
kneepje|truc
knellen|vasthouden|vastklemmen
knelpunt|verkeersknelpunt
knettergek|knots|krankjorum|ploertendoder
kneuswond|kneuzing
knevel|snor
knevelen|knopen|strikken|vastbinden|samenknopen|vastknopen|vastmaken|vastmeren
knieschijf|meniscus
knijper|wasknijper
knijptang|nijptang
knik|strubbeling
knikker|stuiter
knip|knipsluiting
knipmes|naaldhak|stiletto|valmes
knipoog|oogwenk|seintje|seconde
knippen|korten|snoeien|trimmen
knisperen|ritselen
knobbel|knoest|kwast
knoedels|pasta
knoeien|morsen|vlekken
knoeiers|krukken
knoesten|kwasten
knoet|knuppel|ploertendoder
knoflook|look
knokken|strijden|vechten
knol|paard
knolraap|raap
knooppunt|kruispunt|verkeersknooppunt
knop|lichtknop|schakelaar
knopen|samenknopen|strikken|vastknopen
knoppen|schakelaars
knorren|ronken|snorren|zagen
knot|vlecht|wrong
knots|knuppel|krankjorum|ploertendoder|maf|mal
knuffel|liefkozing
knuffelbeest|knuffeldier
knuffelen|liefkozen|vrijen
knutselarij|knutselen|knutselwerk|prutsen|sleutelen
knutselen|prutsen|sleutelen|rommelen
koe|onnozelaar|rund
koehuid|koeiehuid
koekenpan|koekepan
koel|koudmakend|nuchter|zakelijk
koelen|verkoelen
koelinrichting|koelinstallatie
koen|onverschrokken|onvervaard|stoutmoedig
koerier|loopjongen|renbode
koers|richting|route|scheepvaartroute|vaarroute|valuta|traject|zeeroute|wisselkoers
koersen|zeeroutes
koesteren|koestering
koffer|kofferbak
kofferbak|kofferruimte
koffie-extract|oploskoffie
koffieautomaat|koffiemachine
koffiehuis|koffieshop
koffiekan|koffiepot
koffiezetapparaat|koffiezetmachine|koffiezetter
koffiezetmachine|koffiezetter
kogelpatroon|patroon
kogelrond|rond
koken|kokerij|zieden
koker|pennendoosje|personageuitbeelding|waterkoker|rol
kokos|kokosmeel
kolder|wambuis
kolen|steenkolen
kolenwagen|tender
kolken|ronddraaien|wervelen|wentelen|wielen
kolonie|nederzetting|vestiging
koloniseren|settelen|vestigen
kolossaal|reusachtig
kombuis|scheepskeuken
komeet|staartster
komijn|komijnzaad|kummel
komijnzaad|kummel
kommer|mis
kompasstreek|windstreek
komst|overkomst
konijnehok|konijnenhok
koning|monarch
koningin|moederbij|vorst
koningsappel|rijksappel
koningsdochter|prinses
koningsgezind|oranje
konkreet|tastbaar
kooi|vogelkooi
kookpan|pan
kookplaat|rechaud
kool|steenkool
koon|wang
koopakte|koopcontract|verkoopcontract
kooplust|parkeerruimte
kooppenningen|koopsom
koopvrouw|zakenvrouw
koopwaar|ronddwalen|waarden|waren|waardes
koor|zangkoor
koorden|snoeren
koordje|touw|touwtje
koordjes|lijntjes|touwtjes
koorknaap|koraal
koosjer|pluis
koper|opkoper|roodkoper
kopieerapparaat|kopieermachine
koppelen|samenkoppelen|verbinden
koppels|opspannen|spannen
koppelteken|verbindingsteken
koppelwoord|voegwoord
koppig|stijfhoofdig|tegendraads|weerbarstig
koppijn|migraine
kopschuw|schuw
koptelefoon|oortelefoon
koren|zangkoren
korenakker|korenveld
korf|mand
kornuit|vriend
korst|roof|wondkorst
korteafstandloper|sprinter
kortelings|laatst|laatstelijk|onlangs|pas
korten|krimpen|minderen|verminderen
kortgeleden|onlangs|pas|recent|recentelijk|zojuist
kortom|samengevat
kortzichtig|ongenuanceerd
kosmopoliet|wereldburger
kostuum|maatpak|pak
kostuumpop|paspop
kot|krot|krotwoning
kotsen|vomeren
kou|koude
kouseband|kousenband
kousen|nylonkousen
kousje|lampenkousje
kouten|praten
kozijn|vensterkozijn
kraaiennest|uitkijk
kraamhulp|kraamverpleegster
kraaminrichting|kraamkliniek
kraan|waterkraan
kraanwagen|takelwagen
krab|kras|schram
kracht|potentieel|sterkte|volume
krachteloosheid|onmacht
krachtig|nadrukkelijk|uitdrukkelijk
kraken|kritiseren|losbreken|openbreken|openleggen
kraker|succesnummer
kralen|parelen
kralenkrans|krans
kranen|tappen
krapte|schaarste
kras|schram
kredietverlening|lening
kredietwaardig|solvabel|solvent
kreeft|langoustine
kreet|leus|schreeuw|slagzin|strijdkreet|slogan|yell
krentenbol|puistenkop
kreukelen|verfrommelen|verkreukelen
krijg|ontvang
krijger|strijder
krijgertje|tikkertje
krijt|krijtje
krimp|krimping
krimpen|minderen|slinken|verminderen
kring|kringvormig
krioelen|kruipen|wemelen|sluipen|wriemelen
kroestang|krulijzer|krultang
krombuigen|kromtrekken
kromming|kronkel|ronding|verdraaiing
kroonprins|prins|troonpretendent
kroost|nageslacht
kroot|peen|wortel
krop|kropgezwel|slakrop|struma
kropgezwel|struma
krot|krotwoning
kruid|kruiderij
kruiden|smaakstoffen
kruier|sjouwer
kruik|mok|pul|stopfles|waterkruik
kruimeldief|stofzuigertje
kruipen|sluipen
kruisgang|kruisweg
kruising|kruispunt|wegkruising|splitsing
kruispunt|verkeersknooppunt|wegkruising
kruisvaarder|pelgrim
kruit|poeder
kruk|krukje|slinger|poef|zwengel|taboeret
krukas|trapas
krukje|taboeret
krukken|stuntelen
krul|krulvorm|urinoir
krulijzer|krultang
krullenkapsel|permanent
krulspeld|krulstaaf
kuieren|wandelen
kuip|tobbe|vat|waskuip
kuis|reinigen|reiniging|schoonmaak
kuisheid|onbevlektheid|reinheid|zedigheid
kunde|kundigheid|talent
kunne|sekse
kunstgreep|list
kunstleer|skai
kunstrijden|kunstschaatsen
kunststof|plastic
kunstvoorwerp|kunstwerk|meesterwerk
kunstwerk|meesterwerk|werk
kunstzijde|rayon
kurkdroog|uitgedroogd
kurkentrekker|kurketrekker
kus|zoen
kussen|zoenen
kust|kustrand|strand
kuttenkop|ploert
kuur|nuk
kuuroord|sanatorium
kwaadaardigheid|laaghartigheid|slechtheid|verdorvenheid
kwaadheid|razernij
kwaadspreken|roddelen
kwaal|stoornis|verstoring
kwab|lob
kwajongen|lomperd|pummel|vlegel
kwaker|quaker
kwakkel|kwartel
kwalificeren|plaatsen
kwalijk|snood
kwaliteitsartikel|kwaliteitsproduct
kwart|vierde
kwartet|vier|viertal
kwartiermaker|kwartiermeester
kwasi|quasi|zogenaamde
kwasten|kwibussen
kwastenreiniger|oplawaai|peut|opstopper
kwasterig|nuffig|verwaand
kweektuin|kwekerij|tuinbouwbedrijf
kweker|teler
kwekerij|tuinbouwbedrijf
kwel|mis|rouw
kwelling|verschrikking
kwetsuur|letsel|verwonding|wond
kwiek|vrolijk
kwijl|speeksel|spuug
kwijlen|zeveren
kwijt|vergeten
kwik|kwikzilver
kwint|vijfde
kwispelen|kwispelstaarten
kwistig|verkwistend
la|lade|schuiflade
laadplaats|ladingsplaats
laadruimte|scheepsruimte|tonnage
laag|verachtelijk
laaghartigheid|slechtheid
laagstaand|primitief
laagveen|moeras
laakbaar|verwerpelijk
laan|weg
laatst|onlangs
laatstelijk|onlangs
lab|laboratorium
lactose|melksuiker
lacune|ledigheid|leegte|leemte
ladder|schop|trap|trapje
lade|schuiflade
lafenis|verfrissing
lag|lagen|liggen|lig
lagen|liggen
lak|laklaag|vernis
lakei|livreiknecht
laklaag|vernis
lambrisering|lambrizering
lamlendig|lamzalig
lamp|lantaarn|verlichtingstoestel
lampekap|lampenkap
lampenkatoen|lampepit
lampzwart|roet
lamskarbonade|lamskotelet
lamsvacht|pels
lanceren|lancering|wegschieten|start
landelijk|plattelands|rustiek
landen|neerdalen|terechtkomen
landgrens|rijksgrens
landingsbaan|strip
landleger|landmacht
landleven|plattelandsleven
landloper|vagebond|zwerver
landontginning|ontginning
landschapspark|natuurgebied|natuurpark|natuurreservaat
landvoogd|plaatsbekleder|regent|stadhouder
langaanhoudend|langdurig
langbeen|ooievaar
langduriger|langer|langere
langgerekt|langwerpig
langs|ter|via
langslaper|slaapkop
langzaamheid|luiheid|traagheid
langzamer|vertraagd
lans|speer
lantaarn|verlichtingstoestel
lanterfanten|luieren|nietsdoen|niksen|rondhangen
lap|poetslap
lappenwinkel|stoffenwinkel
lariks|lariksboom
las|lasnaad|samenvoeging|tussenvoegsel
lasnaden|lassen
laster|schande|smaad|spotternij
lastezel|muildier|muilezel
lastgeving|licentie|mandaat|opdracht
lastigvallen|teisteren
laten|permitteren|toestaan
latent|potentieel
later|straks|zometeen
laurier|laurierblad|laurierboom
laveren|schipperen
lawaai|schouwspel|spektakel
lector|redenaar|spreker
ledematen|lichaamsdelen
ledenpop|mannequin|model
ledig|leeg|onbezet
ledigen|legen
ledigheid|leegte
leefgemeenschap|woongemeenschap|woongroep
leefomgeving|milieu
leeftijd|ouderdom
leeftijdscategorie|leeftijdsgroep
leefwijze|levensstijl|levenswijze|stijl
leeg|wezenloos
leegeten|opeten
leeghalen|leegplunderen|leegzuigen|persen|plunderen|uitzuigen|uitpersen
leeghoofdig|naief|onbenullig|onnozel|stompzinnig|triviaal
leegknijpen|uitdrukken
leeglopen|vrijlopen
leegplunderen|leegroven|plunderen
leegzuigen|uitzuigen
leek|oningewijde|onkundige
leerboek|schoolboek
leerkracht|leraar|meester|schoolmeester
leerling|pupil|scholier
leerlooien|looien
leermeester|mentor
leerplicht|schoolplicht
leerrijk|leerzaam
leerstelsel|leersysteem
leeuwentand|leeuwetand
legaal|legitiem|rechtsgeldig|wettelijk
legaat|nalatenschap
legborden|planken|schappen
legende|sage
legers|manschappen
legio|ontelbaar|talloos
legitimatie|legitimatiebewijs
legitimatiebewijs|persoonsbewijs
leider|voorman
leiders|opperhoofden|voormannen
leidsel|riem|teugel|toom
leidsels|teugels
lek|lekkage|lekken|ondicht
lekenrechter|schepen|vaartuigen|wethouder
lekkerbek|smulpaap|snoeperd
lekkernij|lekkers|tussendoortje|versnapering
lekkers|snoepgoed|snoepjes|versnapering|zoetigheid
lelie|lelieblad
lelijkheid|ondeugendheid
lellebel|slet|snol
lenen|ontlenen|uitlenen
lengtecirkel|meridiaan
lenigen|verlichten|vervriendelijken|verzachten
lens|objectief
lente|lentetijd|voorjaar
lentemaand|maart
lepel|opscheplepel
lepelen|scheppen
lepralijders|melaatsen
leraar|onderwijzer
les|lesuur|onderricht
leslokaal|lokaal|plaatselijk
lessenaar|schooltafel|schrijftafeltje|schrijftafel
lestabel|rooster
letter|letterteken
lettersoort|lettertype
leuk|wieg
leuning|rug|rugleuning
leus|slagzin|spreuk|strijdkreet
levendigheid|opgewektheid|vrolijkheid
levensbeschouwing|levensopvatting|levensovertuiging
levenselixer|tonic
levensgeschiedenis|levensloop|levenswandel|levensweg
levenskrachtig|vitaal
levensloop|levenswandel|levensweg
levenslust|levensvreugde
levenslustig|monter
levensstijl|levenswijze
levensverzekering|overlijdensverzekering
leverancier|toeleveringsbedrijf
leverbaar|verkrijgbaar
leveringsconditie|leveringsvoorwaarde
leveringstijd|levertijd
lezen|oplezen
liaison|liefdesbetrekking|liefdesrelatie|verhouding|ratio|verkering|relatie
libel|waterjuffer
licentie|mandaat|vergunning
lichaam|vlees
lichaamsvezel|vezel|vezeldraad
lichtbak|lichtreclame|reclamebord
lichtgebouwd|tenger
lichtgeraaktheid|prikkelbaarheid
lichtpunt|lichtstip
lichtzinnig|overmoedig|roekeloos|vermetel
lid|lul|penis|piemel
lied|liedje
liederlijk|onzedelijk|verdorven|verderfelijk
liefdadigheid|liefdadigheidsinstelling
liefderijk|liefdevol
liefdesbetrekking|verkering
liefjes|schatjes|schatten
lieflijkheid|lieftalligheid
liefste|schattebout
lieveheersbeestje|lieveheershaantje
liever|veeleer
lig|liggen
ligbed|sponde
liggen|ligt
lijdelijk|passief
lijken|toeschijnen
lijkenhuis|mortuarium
lijkschouwing|sectie
lijm|medaille|moot|plak
lijn|linie|streep
lijnen|oprichten|strepen|richten|sturen|uitlijnen
lijnrecht|ongebogen|recht
lijst|omlijsting|opsomming|register|tabel|schilderijlijst
lila|violet
lillen|schudden|trillen|vibreren
limousine|slee
lineaal|liniaal|meetlat
linie|streep
link|listig|verbinding
linkervleugel|links
links|linksaf|linksom
linksaf|linksom
linnen|linnengoed|schilderijdoek
liquidateur|vereffenaar
liquidatie|vernietiging
liquide|vloeibaar
liquideren|uitroeien|verdelgen|wegvagen
lispelen|sissen
lithografie|steendruk
lobby|lounge
locken|vergrendelen
locomotief|lokomotief
lodderigheid|slaperigheid
loden|loodzwaar
lof|lofdicht|lofrede|witlof
log|loom
loge|portiershokje|schouwburgplaats|vrijmetselaarsloge
logenstraffen|loochenen|verloochenen|verzaken
logisch|uiteraard
lokaal|plaatselijk
lokker|verleider
lolletjes|schertsen
lomp|onelegant|plomp
lompen|vodden
lomperd|proleet|vlegel
lonend|lucratief|winstgevend|produktief
longaandoening|longziekte
lonken|sjansen
lont|ontsteking
loochenen|ontkennen|verloochenen
loochening|ontkenning
loodrecht|verticaal
loof|lover
loog|loogzout
loonarbeid|loonwerk|werk
loonslip|loonstrook
loopbrug|loopplank
loopwerk|mechaniek|raderwerk
loos|ongevuld|zoekgeraakt
loot|lot|scheut|stekje|takje|loterijlot|spruit|twijg|lotsbestemming
lopen|stappen|stevenen|wandelen|varen
lor|vod
losbarsten|losbreken|openbreken
losbol|schuinsmarcheerder
losdraaien|losschroeven
losjes|soepel
loskomen|losraken
loskoppelen|scheiden|uitsplitsen|splitsen
lossing|ontlading|uitlading
lot|loterijlot|lotsbestemming
loten|verloten
loting|verloting
lotsverbondenheid|saamhorigheid|verbondenheid
lotus|lotusbloem
lovertje|paillet
loyale|trouwe
lozen|uitbannen|uitgooien|uitstoten|uitwerpen
luchthaven|vliegveld
luchtig|speels
luchtledig|vacuum
luchtmacht|luchtstrijdkrachten
luchtpijp|trachea
luchtverbinding|vliegverbinding
luchtverversing|ventilatie
lucratief|winstgevend
luguber|macaber|sinister
luiaard|luilak|luiwammes
luidspreker|megafoon
luiheid|traagheid
luilak|luiwammes
lukken|slagen
lul|penis|pineut|schoft
lurken|sabbelen|slurpen|zuigen
lust|wellust|zinnelijkheid
lusten|wellusten
lustig|vrolijk
luttelbedrag|vriendenprijs
luxe|welstand
luxueus|weelderig
lymf|weefselvocht
lyriek|po
ma|mama|moeder|mamma|moe
maagdarmkanaal|spijsverteringskanaal
maagdelijkheid|ongereptheid
maagperforatie|perforatie
maandagmorgen|maandagochtend
maandblad|tijdschrift
maat|makker
maatje|maatjesharing|makker|vriendje
maatregel|rangschikking|schikking|verschaffing|regeling|voorziening
maatschap|vennootschap
maatschappelijk|sociaal
maatschappij|samenleving|vennootschap
maatschappijleer|sociologie
maatstaf|norm|toetssteen|standaard
machineschrijven|tikken|typen
machinist|meester|treinbestuurder
machteloosheid|onvermogen
machtiging|mandaat|volmacht
machtigingen|volmachten
maestro|meester
maffen|ontpitten|pitten|slapen
maffia|mafia
mag|mogen|toestemmen
magazijn|provisiekamer|voorraadmagazijn|voorraadkamer
magazine|tijdschrift|tv-programma
mager|pover|spichtig|vetarm|tenger
magerte|schraalheid
maillot|panty|pantykous|spanbroek
majesteit|soeverein|vorst
makelaarsprovisie|provisie
makker|onwrikbaar|pal|vriend
mal|modelvorm|sjablone|sjabloon
malversatie|verdonkeremaning|verduistering|zonsverduistering
mama|moeder
mamma|moeder
mammie|moeder
manchet|manchetknoop
mandaat|procuratie
mandekker|verdediger
manege|rijschool
mangel|wringer
manier|methode|wijze
manieren|omgangsvormen|wegen
manifest|mededeling
manifestatie|samenkomst|uiterlijk|vertoon
manlijkheid|mannelijkheid
mannelijk|potent|viriel
mannengek|nimfomane|nymfomane
mannetje|mannetjesdier
manoeuvreren|marcheren
mantel|overjas
mantels|overjassen
manufacturen|stukgoed
map|opbergmap|schrijfmap|ordner
marchanderen|onderhandelen|pingelen
marchandering|onderhandeling
marge|speelruimte|winstmarge|speling
marihuana|weed
marineren|toebereiden
marionet|pop|speelpop
markies|parasol|zonnescherm|zonwering
Mars|expeditie|tocht|toer
marteling|pijniging
mascotte|talisman
maskeren|verhullen
massaproductie|serieproductie
mast|paal
mat|vloerkleed|vloermat
materie|stof
materieel|stoffelijk|tastbaar
mathematica|rekenkunde|wiskunde
mathematicus|wiskundige
mathematisch|wiskundig
matigen|minderen
matiging|mindering|tempering
matinee|namiddagvoorstelling
matje|onderzetter
matuur|rijp|voldragen
mazzel|meevaller
me|mij
mechaniek|raderwerk|werken|werking
medaille|plak
mede|mee
mededeling|statement|uitlegging|vermelding|verbreiding
medeleven|meeleven|rouwbeklag
medelevend|meelevend
medelijden|meewarigheid|rouwbeklag
medespeler|speelkameraad
medicament|medicijn
meedoen|meespelen
meedogenloos|onmenselijk|wreed
meegaand|toegeeflijk|toegevend
meegeven|meesturen|meezenden
meeleven|meevoelen
meelijwekkend|miserabel
meelopen|vergezellen
meelspijs|vliegbasis
meerderen|superieuren
meerekenen|meetellen
meerendeel|merendeel
meermin|zeemeermin
meerstemmig|polyfoon
meeslepen|meesleuren|meetronen
meesleuren|meetronen
meest|uiterst
meestal|veelal
meestens|overwegend|voornamelijk
meesturen|meezenden
meeuw|zeemeeuw
meisjes|wichten
melange|mengsel
melasse|stroop
melden|veiligheidsfunctionaris
melkfabriek|zuivelfabriek
melkvloeistof|wei
melodie|wijs
melodieus|welluidend
memoriseren|onthouden
meneer|mijnheer
menen|opsporen|traceren|vind|vinden
mengeling|mix
mengvorm|tussenvorm
menigten|zwermen
mening|opinie|overtuiging|visie|zienswijze
meningsuiting|oordeel|uitlating|visie|zienswijze
mens|persoon|wezen|zijn
mensdom|mensheid
menstruatie|ongesteldheid|onpasselijkheid
menstruerend|ongesteld
mentaliteit|tijdgeest
menu|menukaart|spijskaart
menukaart|spijskaart
merite|salaris|verdienste
merk|merknaam
messcherp|scherp|vlijmscherp
messias|verlosser
messteek|steek
mest|stront
mesten|vetmesten
metaalslak|slak
metabolisme|stofwisseling
metafoor|vergelijking
metamorfose|vormverandering
meter|peettante
methode|trant
methodisch|planmatig|systematisch
meting|opmeting
metro|ondergrondse
metropool|wereldstad
metselaar|voeger
metselspecie|mortel|puin|steenslag|steengruis
metselwerk|voegwerk
meubelmaker|schrijnwerker|timmerman
mezelf|mijzelf
mi|mie|mihoen
micrometer|micron
middag|namiddag
middenpad|middenweg
mie|mihoen
milieuvervuiling|verontreiniging|vervuiling
militant|oorlogszuchtig
mime|pantomime
min|minteken|zoogmoeder|minus
minachten|verachten
mindering|tempering
mineraalwater|spa|spawater
minimaal|minstens|tenminste
minimum|ondergrens
minister-president|premier
mink|nerts
minkukel|onnozelaar|stommeling|uilenbal|schlemiel|sufferd|sukkel
minnaar|vrijer
minpunt|verliespunt
minteken|minus
minutieus|nauwgezet
minuut|moment|ogenblik|oogwenk|seconde
mirakel|wonder
misbaar|ontbeerlijk
misboek|missaal
misbruikt|verkracht
miskennen|onderschatten|onderwaarderen
mislopen|mislukken
mismaakt|misvormd
mismaaktheid|verminking
misselijk|naar|onpasselijk|onwel
misselijkheid|ongesteldheid|onpasselijkheid
misstand|wantoestand
misstanden|wantoestanden
mist|nevel|waas
mistig|onduidelijk|ongefocust|onscherp|vaag
misvatting|misverstand|vergissing|wanbegrip
misverstand|wanbegrip
mobilofoon|portofoon
modderig|slibachtig
modderpoel|poel|vijver
modebewust|modegevoelig
model|monster|prototype|proefje|specimen
modelleren|vormen
modelzitten|poseren
modieus|trendy
moe|moeder|vermoeid
moederkaart|stamkaart
moederkoek|placenta
moederschoot|schoot
moeilijkheid|narigheid|penarie|probleem
moeiteloos|vanzelf
moerbei|moerbeiboom
moersleutel|schroefsleutel|spanner|steeksleutel
moes|puree
moet|moeten
moeten|willen
mof|mouw
mogelijkheid|potentie
moker|voorhamer
molenaar|mulder
molenrad|rad|waterrad|wagenwiel
mollig|volslank
moment|ogenblik|uur
momenteel|nou|nu
mompelen|murmelen|prevelen
mondeling|verbaal
monden|muilen
mondiaal|universeel|wereldomvattend|wereldwijd
mondingen|openingen
monitoren|volgen
monotoon|saai
monter|opgetogen|tierig|opgewekt|vrolijk
monteur|operator|techneut|technicus
mooi|smaakvol
mooipraterij|vleierij
moois|pracht
mooist|mooiste
moorden|vermoorden
moordpartij|slachtpartij
moot|plak|tranche|schijf
moraal|zedenleer
morgen|ochtend
morsen|smetten|vlekken
morsig|ongeregeld|onopgeruimd|slordig
motivator|stimulans
motorracen|racen|rennen|scheuren
mousseren|sprankelen|tintelen
mug|steekmug
muggenziften|muggeziften
multifunctioneel|multifunctionele
multomap|ringband
muntsoort|valuta|wisselkoers
muren|wanden
muskaat|nootmuskaat
must|vereiste|voorwaarde
muteren|veranderen
muurplug|plug
muziek|naslag|rietje|opzoeken
muziekblad|muziektijdschrift
muzieknoot|noot|toon
muziekstuk|opus
naad|voeg
naakt|naaktfiguur
naaktloper|nudist
naaldhak|stiletto
naamkaartje|visitekaartje
naar|zoals
naargelang|naarmate
naarstig|verwoed
naast|ongeacht
nabezorgen|naleveren
nablijven|nakomen|schoolblijven
nabootsen|namaken|vervalsen
naburig|omliggend
nadeel|schade
nadelig|ongunstig|schadelijk|onvoordelig
nadenken|overpeinzen|piekeren|peinzen
nadenkend|verstandig
naderen|tegemoetkomen
nadoen|navolgen
nadrukkelijk|uitdrukkelijk
nagebootst|nagemaakt
nagel|spijker
nagenoeg|schier|welhaast
nageslacht|nakomelingen|telgen
naief|onnozel
najagen|nastreven
nakomeling|telg
nakomelingen|telgen
nalaten|veronachtzamen
nalatigheid|verzuim
naleven|opvolgen
namaker|vervalser
napraten|nazeggen
narcose|verdoving
narekenen|natellen
naslaan|naslag|opzoeken
nasporing|opsporing|speurwerk
nat|regenachtig|vloeistof|vocht
natheid|nattigheid|vochtigheid
naties|volken
nationaal|vaderlands
natrekken|verifi
naturisme|nudisme
natuurgebied|natuurreservaat
natuurgetrouw|realistisch
nauw|nauwsluitend|strak
nauwgezet|nauwkeurig|precies
nauwgezetheid|nauwkeurigheid|precisie
nauwsluitend|star|strak|strakgespannen
navigatie|scheepvaart|zeevaart
navolgen|opvolgen|volgen|volgt
nawoord|slotwoord
nederig|ootmoedig
nederigheid|onderdanigheid
nederlaag|overwonnen-worden|verlies
nederzetting|vestiging
neerdalen|neerkomen|terechtkomen
neergang|teloorgang
neerkwakken|smakken
neerleggen|wegleggen
neerploffen|ontploffen|ploffen
neerschieten|overhoopschieten
neerslaan|ombladeren|omslaan|onderuithalen|vloeren|tekkelen
neerslachtigheid|zwaarmoedigheid
neersteken|overhoopsteken
negatief|ontkennend
neger|zwarte
nekwervel|wervel
nerveus|zenuwachtig
net|netwerk|nipt|televisiekanaal|netwerken
netelig|precair
netheid|onberispelijkheid|ordelijkheid|properheid
netspanning|spanning|strakheid
netto|onbelast
neuken|ontlasten|seks|poepen
neus|reukorgaan
neushoorn|rinoceros
neutraal|onpartijdig|onzijdig
neuzen|rechercheren|speuren|vorsen
nevenactiviteit|nevenfunctie
neveneffect|nevenwerking
niet|noch
nieten|vastnieten
nietszeggend|onbeduidend|onbelangrijk|triviaal
nieuw|opzienbarend|verfrissend|verrassend
nieuwheid|oorspronkelijkheid|originaliteit
nieuws|nieuwsbericht|televisiejournaal
nieuwsbrief|rondschrijven
niezen|proesten
nihil|nul
niksen|rondhangen
nimfomane|nymfomane
nimmer|nimmermeer|nooit
nippertje|valreep
nodeloos|onnodig|overbodig
noemen|vermeld|vermelden
nominatie|redevoering|voordracht
nood|noodtoestand|noodwendigheid
noodgeval|spoedgeval
noodlottig|rampzalig
noodrantsoen|rantsoen
noodsein|noodsignaal
noodzaak|urgentie
nor|strafgevangenis
norm|standaard|vaandel
normaliseren|standaardiseren
noteboom|notenboom
notedop|notendop
noten|notenhouten
noteren|opschrijven
novelle|verhaal|wet
nuchter|zakelijk
nut|nuttigheid|waarde|zin
nutteloos|onzinnig|tevergeefs|zinloos
nuttigen|verschalken
ober|tafelbediende
objectief|onpartijdig
obligatie|schuldbrief
observator|waarnemer
observatorium|sterrenwacht
oceaan|sop|wereldzee|zee
ochtend|voormiddag
ochtendjas|peignoir
odeur|parfum
oef|oei
oefenen|ontwikkelen|repeteren
oen|onnozelaar|sufferd
oenen|sullen
oer|tijd
oermoeder|stammoeder
oerwoud|rimboe
oeverriet|riet|rotan
oevers|wallen
offer|offerande|opoffering
offerdier|slachtoffer
officier|stafmedewerker
officieus|onofficieel|zijdelings
oftewel|tegenstelling|verklarend
ogenschijnlijk|schijnbaar
olie|zonnebrandolie
oliesel|zalving
olijkerd|paljas
om|wegens
omarmen|omhelzen
omarming|omhelzing
ombladeren|omkeren|omslaan
omcirkelen|omsingelen|omsluiten
omgaand|omgaande
omgang|optochten|ronde|processies|rondje|tournee
omgangstaal|spreektaal
omgekeerde|tegenovergestelde
omgeven|omringen
omgeving|omlijning|omstreken|omtrek|vorm
omgooien|omvergooien|omverwerpen
omheenvliegen|rondvliegen
omhoog|opwaarts
omhoogdraaien|opdraaien
omhooggooien|omhoogwerpen|opgooien|opwerpen
omhooghalen|ophalen
omhoogwerpen|opwerpen
omhulsel|omkleedsel|omwindsel
omissie|weglating
omkeren|teruggaan|teruggrijpen|vergaan
omkijken|omzien|terugkijken
omleiding|wegomlegging
omloop|roulatie|uitje|wandeling
ommekeer|omwenteling|revolutie|rotatie
omploegen|ploegen|spitten|wroeten
omroep|omroeporganisatie|omroepvereniging|zuil
omrollen|omvallen|omvervallen|omwentelen
omruiling|ruil
omschakelen|overschakelen
omschakeling|wijziging
omslagdoek|shawl|sjaal
omslagdoeken|sjaals
omspringen|omverspringen
omvallen|omvervallen
omvat|omvatten
omver|ondersteboven
omvergooien|omverwerpen
omverrijden|overrijden
omvormen|reorganiseren|vervormen
omwenteling|revolutie|rotatie
omwentelingen|toeren
omwisselen|omwisseling|verwisseling
omwisseling|vervanging|verwisseling
omzien|terugkijken
omzwerven|rondreizen|zwerven|rondzwerven
onaandachtig|ongeconcentreerd|onoplettend
onaandachtigheid|onoplettendheid
onaangebroken|ongebruikt
onaangenaam|ongelegen|onplezierig|onprettig
onaanvaardbaar|onacceptabel
onaanvechtbaar|onbetwistbaar
onaardig|onvriendelijk
onafgewerkt|onvolkomen|onvolmaakt
onafhankelijkheid|zelfstandigheid
onafwendbaar|onherroepelijk|onvermijdelijk
onappetijtelijk|walgelijk
onbedaarlijk|onstuimig|uitzinnig
onbeduidend|triviaal|vruchteloos
onbegaan|ongevoelig
onbegonnen|onhaalbaar|onpraktisch|onuitvoerbaar
onbegrensd|onbeperkt
onbehaaglijk|ongezellig|onwennig
onbehoorlijk|onpassend
onbekende|vreemde|vreemdeling
onbekenden|vreemdelingen
onbelangrijk|triviaal
onbeleefd|ongemanierd
onbenulligheid|onkundigheid|onwetendheid
onbenut|ongebruikt
onberekenbaar|wispelturig
onbeschrijflijk|onnoemelijk
onbeschroomd|stoutmoedig|vrijmoedig|vrijpostig
onbestendig|veranderlijk|wisselend|wisselvallig
onbevattelijk|ondoorgrondelijk|onpeilbaar
onbevlektheid|reinheid|vlekkeloosheid
onbevredigd|onverzadigd
onbevredigend|teleurstellend
onbewust|onopzettelijk
onbezorgdheid|zorgeloosheid
onbillijk|oneerlijk|onredelijk|ongefundeerd|ongegrond|onrechtvaardig
ondenkbaar|onvoorstelbaar
onderaannemer|uitvoerder
onderafdeling|vertakking
onderarm|voorarm
onderbouwen|onderheien
onderbroek|slip|slipje
onderbuik|onderlichaam
onderdanig|onderworpen|ootmoedig|serviel|slaafs
onderdrukt|verbeten
onderen|onderop
ondergang|teloorgang
onderhavig|voorliggend
onderhouden|verzorgd
onderkant|onderzijde
onderlegger|onderzetter
onderling|wederkerig|wederzijds
ondermaats|onvolgroeid
onderofficier|sergeant
onderschatten|onderwaarderen
onderscheid|verschil
onderscheidenlijk|respectievelijk
onderschepping|vangst
onderschept|opgevangen
ondersteuning|sponsoring|steun|support
ondertrouwen|verloven
ondertussen|terwijl
onderuitgaan|slippen|uitschieten|uitschuiven|uitglijden|wegglijden
onderuithalen|tekkelen
onderverdeeld|onderverdelen
ondervragen|uithoren|verhoren|uitvragen
ondervraging|overhoring|verhoor
onderwerp|stellingname|subject|stof|thema
onderwijzen|opleiden|scholen
onderwijzeres|schooljuffrouw
onderworpen|verslagen
onderzocht|onderzoeken|speuren|vorsen
onderzoek|research
onderzoeker|reseacher|vorser|tester
ondoenlijk|onhaalbaar|onuitvoerbaar
ondragelijk|onverdraagbaar
onduidelijk|vaag|wollig
onecht|onjuist|schurkachtig|onwaar|slecht|vals
oneerbaar|onzedelijk
oneffen|ruw
onelegant|plomp
onenigheid|uniek
onfortuinlijk|ongelukkig|onzalig|rampzalig
ongebondenheid|vrijheid
ongedwongen|ongekunsteld
ongefundeerd|ongegrond|ongemotiveerd
ongehinderd|ongemoeid|ongestoord
ongekend|onge
ongekookt|rauw
ongelijkheid|project
ongelovig|ongodsdienstig
ongelukken|ongevallen
ongelukkig|onzalig
ongemakken|ongerieven
ongeoorloofd|wederrechtelijk
ongepeld|ongeschild
ongeregeld|onordelijk|rommelig|wanordelijk|slordig
ongeregeldheden|onlusten
ongerust|verontrust
ongetemd|ruig|vertoornd|wild|ruw|woedend|woest
ongetoomd|teugelloos
ongeveer|ruwweg|vrijwel
ongeveinsd|oprecht
ongewenst|ongewild
ongezien|onopgemerkt
ongezond|onwel|ziekjes|ziek
ongrijpbaar|ontastbaar
ongunstig|onvoordelig
onhandelbaar|onhanteerbaar|tegendraads|weerbarstig
onhandig|slungelig|sukkelig|stumperig
onheil|ramp|tegenslag|tegenvaller|rampspoed|tegenspoed|terugslag|terugstoot
onheilspellend|sinister
onherbergzaam|steriel
onherroepelijk|onvermijdelijk
onkunde|onkundigheid|onwetendheid
onkwetsbaarheid|onschendbaarheid
onlangs|recentelijk
onloochenbaar|onmiskenbaar
onlosmakelijk|onverbrekelijk
onmenselijkheid|wandaad|wreedheid
onnauwkeurig|onzorgvuldig
onnozelaar|stommerd|stommerik|sufferd|sul
onomstotelijk|onweerlegbaar
onontkoombaar|onvermijdelijk
onoorbaar|ontoelaatbaar
onopgehelderd|onopgelost|onverklaard
onopgemaakt|onopgesmukt
onopgeruimd|slordig
onordelijk|wanordelijk
onoverkomelijk|onoverwinnelijk
onovertroffen|superieure
onpasselijk|onwel
onrechtmatig|wederrechtelijk
onrein|onzindelijk
onrendabel|verliesgevend
onrust|rumoer
onrustig|turbulent|woelig
ons|onzerzijds
onschuldig|schuldeloos
onstuimigheid|turbulentie|werveling
ontbieden|oproepen|sommeren
ontbindbaar|oplosbaar
ontbinding|verrotten
ontbonden|opgeheven|uiteengegaan
ontbranden|ontvlammen
ontbreken|verzaken|verzuimen
ontdoen|uitbuiten
ontdooien|smelten
onteerd|verkracht
onteren|ontheiligen|ontwijden
ontering|verlaging
ontglippen|ontkomen|ontvluchten|vluchten
ontgoochelen|tegenvallen|teleurstellen
onthaal|ontvangst
ontheiligen|ontwijden|schenden
onthullen|ontmaskeren
onthutst|stup
ontkerkelijking|secularisatie
ontkomen|ontsnappen|ontvluchten|wegvluchten
ontkrachten|ontzenuwen|weerleggen
ontlading|uitlading
ontlasten|poepen
ontlasting|stoelgang
ontnemen|stelen
ontpitten|pitten
ontrafelen|ontwarren|oplossen|uitpluizen
ontrollen|uitrollen
ontrouw|overspelig
ontruimen|verlaten
ontslagaanvraag|opzeggen|opzegging|reciteren
ontsluiten|opendoen|openen|openmaken
ontsnappen|ontvluchten|vluchten|weggaan
ontsnapping|ontvluchting|uitbraak|uitbreken
ontsnappingsroute|vluchtweg
ontspanning|recreatie
ontstaan|ontstaat|ontwikkeling|voortkomen|realisatie
ontstaat|vormt
ontstellen|verontrusten
onttrekken|onttrekking
ontvanger|recipi
ontvangkamer|ontvangstruimte|salon
ontvangstbewijs|re
ontvankelijk|openstaand|vatbaar
ontvankelijkheid|openheid|rondborstigheid
ontvluchten|vlieden|weglopen|vluchten|wegvluchten
ontvouwen|openvouwen|uiteenzetten|uitklappen|uitleggen|uitslaan|verduidelijken
ontvreemden|stelen|vervreemden
ontwapenen|ontwapening
ontwaren|opsporen|traceren|zoeken
ontwarren|selecteren|uitpluizen|uitzoeken
ontwerper|uitvinder
ontwikkelen|uitbouwen
ontwikkelingsfase|ontwikkelingsstadium|stadium
ontwikkelingshulp|ontwikkelingswerk
ontwrichting|verzwikking
ontzet|verbouwereerd
onverenigbaar|strijdig|tegenstrijdig|tegen
onvergetelijk|onvergetelijke
onverhoeds|onvermoed|onverwacht|onverwachts|onvoorzien|plotseling
onvermengd|onversneden|puur
onvermoed|onverwacht
onversaagd|onverschrokken
onverzorgd|verwaarloosd
onvolkomen|onvolmaakt
onvoorspelbaar|wispelturig
onvruchtbaarheid|vruchteloos
onwijs|super|supergaaf
onwrikbaar|pal|vasthoudend|volhardend|standvastig
onzichtbaar|waarneembaar|zichtbaar
onzinnig|zinloos
oogsten|plukken|verzamelen
oogverblindend|schitterend|verblindend
ooit|uiteindelijk
ook|zowel
oordeel|vonnis
oordeelkundig|vakkundig
oordeelvelling|uitspraak|veroordeling|vonnis
oorlel|oorlob
oorspronkelijk|origineel
oorspronkelijkheid|originaliteit
oorzaken|redenen
opbergblik|trom|trommel
opbergen|wegbergen|wegsluiten
opbergmap|ordner
opblinken|oppoetsen|wrijven|poetsen
opbouw|ordening|stelsel|structuur|rangschikking|systeem
opbreken|weggaan
opbrengen|opleveren
opbrengst|profijt|winst
opdat|zodat
opdienen|opdissen|voorplakken|voorzetten
opdirken|optutten|uitdossen
opdoemen|verrijzen
opdraaien|opwikkelen|opwinden|prikkelen
opdrogen|uitdrogen|verdorren|verdrogen
opeenhoping|opeenstapeling|ophoping|stapel
opeenvolgingen|reeksen|series
opeisbaar|opvorderbaar
opeisen|opvorderen|vordering
openbaar|publiek
openbaarmaking|publicatie
openbaren|publiceren|uitbrengen|uitgeven
openbreken|openleggen
opendoen|openmaken
openhaard|schoorsteenmantel|schouw
openhartig|vrijelijk
openheid|oprechtheid|rondborstigheid|rondheid
openhouden|vrijhouden
openscheuren|rijten
openvouwen|uitklappen|uitslaan|uitspreiden|uitvouwen
operatief|werkklaar
operator|technicus
opfrissen|verfrissen|verkwikken|verlevendigen
opgaaf|opgave
opgaan|opkomen
opgave|probleem|vraagstuk
opgeblazen|opgezwollen
opgedoekt|opgeheven|uiteengegaan
opgehelderd|opgeklaard|verduidelijkt|uitgelegd|verklaard
opgekropt|verbeten
opgelapt|versteld
opgemaakt|opgesteld
opgemerkt|waargenomen
opgevat|toegelaten
opgeven|opofferen|prijsgeven
opgevuld|volgestopt
opgewekt|verguld
ophalen|schuldig|verwijderen|weghalen
ophangen|ophanging|opknopen
ophelderen|verduidelijken
ophikken|ophoesten
ophitsen|provoceren|uitlokken
ophouden|sterven|temporiseren|uitsterven|vertragen
opklapbaar|opvouwbaar
opklaren|verduidelijken
opkopen|overnemen
oplaaien|opvlammen
opleiden|samendrommen|scholen
opleiding|vorming
opletten|uitkijken|waken
oplettend|vrolijk|wakker
opleven|verlevendigen
opleveren|schuiven|voortschuiven
oploopje|samenkomst|toeloop
oplossing|soelaas|uitkomst|vraag
opluchting|verademing
opluisteren|opsieren|optuigen|tooien|versieren
opmaken|potverteren
opmarcheren|oprukken
opmars|voortgang|vooruitgang
opname|opvang
opnemen|opvangen|tapen
opnieuw|weer
opnoemen|opsommen
opofferen|prijsgeven
oponthoud|retardatie|vertraging|stagnatie|stremming
oppakken|oppikken|oprapen
opperen|suggereren
opperhoofd|stamhoofd
opplakken|vastlijmen
opponent|tegenstander
oppositie|tegenpartij
oppotten|potten
oprechtheid|rechtschapenheid|rondborstigheid
oprekken|rekken|uitstellen|uitstrekken|vertragen
oprichten|opstarten|opzetten
oprijlaan|oprit
oproeren|rellen
oprollen|opstropen
opruiming|schoonmaken|uitverkoop
opscheppen|snoeven
opschrijven|registreren
opschuiven|vooruitschuiven
opsieren|optuigen|verfraaien|verluchten|tooien|versieren
opslagplaats|opslagruimte|pakhuis|warenhuis
opslokken|schransen|zwelgen
opslorpen|opslurpen
opsluiten|vastmaken|vastzetten
opsmuk|versiering
opsnuiven|snuiven
opspannen|spannen
opspringen|springen
opstaan|verering|verheffen
opstandeling|rebel
opstapeling|stapel
opstapje|traptrede|trede
opstappen|vertrekken|weggaan
opstijgen|sprong|wegvliegen|stijging
opstijgend|stijgend
opstopping|verkeersopstopping|verstopping
optelling|som
optellingen|sommen
optelsom|samenvoeging
optochten|processies
optreden|performen|spelen
optutten|uitdossen
opveren|veren
opvoedkunde|pedagogie
opvoedkundig|pedagogisch
opvoeren|vergroot|vergroten|vertonen
opvolging|successie
opvouwen|vouwen
opvreten|verorberen|verslinden
opvulling|vulling|vulsel|vulstof
opwaardering|verbetering
opwarmen|warming-up
opwarming|verhitting
opwikkelen|opwinden
opzeggen|reciteren|voordragen
opzeggingstermijn|opzegtermijn
opzettelijk|weldoordacht|weloverwogen
opzetten|toenemen
opzetting|zwelling
opzichter|opziener
opzichters|opzieners
opzuigen|stofzuigen|wegzuigen
ordenen|rangeren|regelen|schiften|schikken|sorteren|verzoenen
ordinair|vulgair
orgie|sexfeest
orthodox|rechtzinnig
ossehaas|ossenhaas
oudedagsvoorziening|pensioen|spaarpotje
oudejaarsavond|oudjaar
ouder|pa|vader|papa
ouderschapsverlof|zwangerschapsverlof
oudgediende|veteraan
oudste|senior
outfit|uitrusting
outillage|uitrusting
over|overheen
overblijfsel|restant
overblijven|resteren
overbluffen|overdonderen|verbluffen
overbluft|overdonderd|overrompeld
overboeking|overschrijving
overbrenging|vervoer
overbrieven|verklikken
overdenken|overwegen
overdonderd|overrompeld
overdonderen|verbluffen
overdonderend|overweldigend
overeind|rechtop|rechtopstaand|staand
overhaast|voorbarig
overhebben|overhouden
overheerlijk|reuzelekker
overheidsinstelling|overheidslichaam
overhevelen|overtappen
overigens|trouwens|verder
overkant|overzijde
overkappen|overwelven
overkomen|overvallen
overladen|overstelpen
overleven|voortbestaan|voortduren
overleveringen|tradities
overloop|portaal|vestibule
overlopen|oversteken
overmannen|overmeesteren|overweldigen
overmeesteren|overstelpen|overweldigen
overmoedig|roekeloos|vermetel|waaghalzig
overrompelen|overvallen
overschot|surplus
overschotten|resten
overspannen|overwerkt
oversteek|oversteekplaats|zebrapad
oversteekplaats|zebrapad
oversteekplaatsen|zebra's
overtreder|wetsovertreder
overtredingen|vergrijpen
overtreffen|verbeteren
overtuigdheid|overtuiging
overuur|overwerk
overvloedig|rijkelijk|royaal|ruimschoots
overvol|propvol|stampvol
overweldiging|verleiding|verovering
overwinnen|verkrijgen|verslaan|winnen
overwinning|triomf|zege|zegepraal
overwonnen|verslagen
overzetten|transponeren|vertalen
overzicht|totaalbeeld|uiteenzetting|verhaal
oxideren|oxyderen
pa|paps|vader
paar|twee
paard|vos
paardebloem|paardenbloem
paardekracht|paardenkracht
paardenfokplaats|stoeterij
paardenstaart|paardestaart
paardenwagen|wagen
paarlemoer|parelmoer
paars|purper
pachten|verhuren
pact|verdrag
pad|padachtige
paddestoel|paddestoelsoort|zwam
padvinder|verkenner|verkenningsvliegtuig
page|pagina
pakje|pakket
pakket|postpakket
pamflet|strooibiljet|vlugschrift
pandemonium|tumult
pannekoek|pannenkoek
pannen|stoofpannen
pantoffels|sloffen
pantserwagen|tank
panty|pantykous|spanbroek|tricot
papiertje|velletje
parachute|valscherm
parade|show|vertoning|voorstelling
parasiet|uitvreter
parasol|zonnescherm|zonwering
pardon|sorry
parkeerautomaat|parkeermeter
parkeergebouw|parking
parkeerplaats|parkeerterrein
parkeerwacht|parkeerwachter
parket|parketvloer
parodie|persiflage
particulier|zelfstandig
partners|vrouwen
pas|schrede|stap
pashokje|paskamer
passagier|reiziger
passant|voorbijganger
passe-partout|passepartout
passen|schreden|stappen|voetstappen
pastor|predikant
pat|patstelling
pater|priester|vader
pathologisch|ziekelijk
patroon|raderblad
pauze|rust
pechstrook|vluchtstrook
peen|wortel
peetoom|peetvader|peter
pek|teer
pelgrimage|pelgrimstocht
pen|schrijfstift|vulpen
pendule|uurwerk
penis|piemel|pik|roede
pennenvrucht|pennevrucht
pens|voormaag
pentekening|prent
per|vanaf
percent|procent
perceptie|waarneming
perfect|volmaakt
perfectie|volmaaktheid
performance|show|vertoning|voorstelling
performen|spelen
periode|tijdsperiode
periodes|tijdvakken
periodiek|tijdschrift
permanent|voortdurend
permitteren|toelaten|veroorloven|toestaan
persen|uitpersen
personageuitbeelding|rol
personeelsbestand|personeelsbezetting|personeelsgegevens
persoonlijk|subjectief
perspex|plexiglas
perswee|wee
pessimist|zwartkijker
pesten|treiteren
pestkop|treiteraar
petitie|verzoekschrift
petoet|strafgevangenis
peuk|sigaret
peut|terpentine
piek|top
piekerig|tobberig
piekfijn|tiptop
pijlen|stelen
pijlers|steunpilaren
pijnscheuten|scheuten|stekken
pijp|tabakspijp
pikant|zinnenprikkelend
pillen|tabletten
pilletje|tablet
piloot|vliegenier|vlieger
piloten|vliegeniers|vliegers
pin|speld
pinda|pindanoot
pineut|sigaar
pinnen|spelden
pionier|voortrekker|wegbereider
piraat|zeerover
piste|wielerbaan
piston|trompet|zuiger
pittoresk|schilderachtig
plaatje|singeltje
plaats|positie
plaatsbekleder|stadhouder
plaatsbespreking|reservering
plaatsen|plekken
plaatsvervangend|subordinaat|waarnemend|subsidiair
plaatsvervanger|representant|vertegenwoordiger
plaatsvervangers|vervanger
plakband|tape
plakje|schijfje
plakkers|plakplaatjes|stickers
plakplaatjes|stickers
plakzegel|zegel
plan|project
plank|schap
planken|schappen
planmatig|systematisch
planning|programma
planologie|stedenbouw
plantestekje|scheut|schuilplaats|spruit|schoot|stekje|stek
plas|poel|vijver
plassen|urineren|wateren|zeiken
plastisch|vormgevend
plat|volks
platdrukken|pletten
platform|podium|toneel|verhoging|toneelpodium
platvink|portemonnee
plausibel|vermoedelijk|waarschijnlijk
plausibiliteit|waarschijnlijkheid
plechtigheid|ritueel|ritus
plein|stadswijk
pleister|stuc
pleit|spreken|verdedigen
plezant|plezierig|prettig
plezier|vreugde
pleziertochtje|uitstapje
ploegbaas|voorman
ploegvoren|voorn|voren
plomberen|vullen
plotseling|schielijk
plotten|verwikkelingen
plotter|schrijver
pluche|pluis
pluim|veer
pluizen|vlokken
plunderen|roven|stelen|wondkorsten
podium|toneel|toneelpodium
poef|taboeret
poep|schijt|stront
poets|streek
poetsvrouw|schoonmaakster
politie-academie|politieschool
politiek|staatkundig|staatsbeleid
polygoon|veelhoek
pompstation|tankstation
poneert|stelt
ponsen|stansen
pont|pontveer|veerdienst|veerboot
pontveer|veerdienst
pook|versnellingshandel
pop|speelgoedpop|speelpop
poppenkast|poppentheater
porcelein|porselein
porno|pornografie
portefeuille|portemonnaie
porties|segmenten
post|postbode
posten|terpostbezorging
postscriptum|ps
postuleren|vooronderstellen
postwissel|spoorwegwissel|wissel|wisselbrief
potje|wedstrijdje
pottekijker|pottenkijker
praatprogramma|talkshow
pralen|pronken
predikanten|voorgangers
prefereren|uitverkiezen|verkiezen
prematuur|voortijdig
premie|verzekeringspremie
premisse|vooronderstelling|voorwaarde
prepareren|voorbewerken
prepensioen|vut
presenteren|voorleggen
presentje|verjaardagscadeau
president|voorzitter
prestige|status
pretenderen|verduidelijken|voorgeven|verklaren
prieel|tuinhuisje|zomerhuisje
prijzen|roemen|verheerlijken
pril|vroeg|vroegtijdig
prins|troonpretendent
prioriteit|voorrang
pro|professional|voor
proberen|trachten
probleemstelling|stelling|vraagstelling
procedure|proces
proces|veranderingsproces
processie|stoet
producent|producer
productie|produktie|vervaardiging
productieproces|produktieproces
produktief|winstgevend
proef|proefwerk|test
proefdier|proefkonijn
proefje|specimen
proefwerk|repetitie|test|toets
proeven|smaken
profeet|voorspeller|ziener
profiteur|uitvreter
prognose|verwachting|vooruitzicht
programmatuur|software
progressie|voortgang
progressief|vooruitstrevend
prolongatie|vernieuwing
prolongeren|voortzetten
proloog|voorbericht|voorwoord
prominent|vooraanstaand
prooi|prooidier
propaedeuse|propedeuse
propaganda|reclame
proper|zindelijk
proponent|voorstander
proportie|verhouding
proposities|voorstellen
propvol|stampvol
prospect|uitzicht
protesteren|sputteren|tegenspartelen|tegenspreken|tegensputteren|tegenstribbelen|tegenwerpen|verzetten
provisiekamer|voorraadkamer
provoceren|uitlokken
provocerend|uitdagend
prullenbak|prullenmand
prutsen|rommelen
psychisch|psychische
publiceren|spenderen|uitbrengen|uitgeven
pudding|vla
pui|vooraanzicht|voorkant|voorzijde
puinhoop|zooi
puist|puistje|pukkel|tas|zwelling
puistje|pukkel|steenpuist
pummel|vlegel
punk|punker
puntig|spits|spitsvormig|toegespitst
pure|zuivere
put|waterput
putten|waterputten
puur|zuiver
quasi|zogenaamde
raadhuis|stadhuis
rabbi|rabbijn
race|wedloop|wedren|wedstrijd
racisme|vreemdelingenhaat
rad|wagenwiel|wiel
radeloosheid|wanhoop
radiaal|straalsgewijs
radiateur|radiator
radiatie|schijnsel|straling|uitstraling
radiostation|stations|zender
rag|spinrag|web
railing|wegmarkering
rails|spoorlijn
rakelings|ternauwernood
raken|treffen
raket|vuurpijl
ramen|reken|rekenen|schatten|tellen
raming|schatting|taxatie|waardebepaling
rancuneus|wraaklustig|wraakzuchtig
rand|zoom
randgemeente|voorstad
Randstad|Rotterdam
rangeren|sorteren
rangnummer|rangtelwoord|volgnummer
rangorde|volgorde
rangordenen|rangschikken
rapheid|vlugheid
rapporteur|verslaggever
rare|zonderling
rariteit|zeldzaamheid
raspen|schaven|schuren
rataplan|rommel|rotzooi
rationeel|verstandelijk
ravage|verwoesting
ravotten|stoeien
razen|woeden
razernij|toorn|woede
realiseerbaar|verwezenlijkbaar
realiteit|werkelijkheid
reanimeren|verlevendigen
receptie|verwelkoming
rechercheren|snuffelen|speuren
rechercheur|speurder
recht|rechtspleging|rechtspraak
rechtbank|tribunaal
rechtdoor|rechtuit
rechtop|rechtopstaand|staand
rechtsachter|rechtsback
rechtsaf|rechtsom
rechtsbijstand|rechtshulp
rechtsgrond|rechtstitel
rechtsherstel|rehabilitatie
rechtspleging|rechtspraak
recidive|terugval
reciteren|voordragen
reclame|reclameadvertentie
recreant|toerist|vakantieganger
rector|schoolhoofd
reddingsboot|sloep
rede|redevoering|toespraak
redekunstig|retorisch
redenaar|spreker
redenatie|redeneertrant
redenen|uitgangspunten
reeksen|series
referaat|verslag
referent|verslaggever
referentie|toespeling|verwijsbrief|verwijzing
reflecteren|ricocheren|terugkaatsen|stuiten|weerschijnen|weerspiegelen
reflectie|spiegeling|weerspiegeling
regel|voorschrift|wet|wetmatigheid
regeling|schaderegeling|vereffening
regelschroef|stelschroef
regenseizoen|regentijd
regenworm|worm|wurm
regime|staatsbestel
rei|reidans
reikwijdte|verspreidingsgebied
reinheid|vlekkeloosheid|zuiverheid
reiniging|schoonmaak|schoonmaken|zuivering
reinigingsdienst|stadsreiniging
reis|trektocht
reisboek|reisgids|reisleider
reisleider|reisleidster
reisplanning|reisverhaal
reizen|rondreizen|trekken|zwerven
rek|stellage
rekbaar|veerkrachtig
reken|rekenen
rekening-courant|rekeningcourant
rekenkunde|wiskunde
rekenmachine|zakjapanner
rekest|verzoekschrift
rekken|temporiseren|uitstrekken|vertragen
rekwestrant|verzoeker|vrager
relaas|verhaal
renaissance|wedergeboorte
rendabel|winstgevend
rennen|sprinten
renner|wielrenner
renovaties|verbouwingen
reorganiseren|verbasteren|vervormen
repliek|verweerschrift|weerwoord
reservaat|wildpark
reserveonderdeel|vervangstuk
reserveren|voorbehouden
resoneren|weergalmen
respijt|uitstel
rest|surplus
restauratie|stationsrestauratie
restitutie|terugbetaling
restituties|terugbetalingen
restjes|sprankjes
restrictie|voorbehoud
retorica|retoriek
retourneren|terugzenden
return|terugwedstrijd
reuk|reukvermogen|reukzin
reukvermogen|reukzin
reukzakje|sachet
reunie|weerzien
reus|titaan
revanche|vergelding
ribben|ribbenkast
richten|uitbalanceren|uitlijnen
richting|wending|windrichting
ricocheren|terugkaatsen
rieken|stinken
riem|roeiriem
rietland|rietveld
rijkdom|welvaart
rijke|vermogende
rijkelijk|ruimschoots
rijp|voldragen
rijpen|rijpingsproces
rijstwijn|sake
rijwegen|wegen
rijwielstalling|stalling
ring|stadionring
ringbaan|ringweg|rondweg
ringetje|rondje
ringweg|rondweg
rinkelen|tingelen
rins|zurig
risicovol|riskant
ritme|tempo
rob|zeehond|zeerob
robbedoes|wildebras
robbertje|vechtpartij
robuust|zwaargebouwd
roeispaan|spaan
Roemeen|Roemeni
roemen|verheerlijken
roer|stuurroer
roffelen|trommelen
roggebloem|roggemeel
rokkenjager|vrouwenjager
rollen|wentelen
rommel|troep|warboel|warhoop
rommelmarkt|vlooienmarkt
rompen|torso's
rondborstigheid|rondheid
rondbrengen|thuisbezorgen
ronddelen|rondgeven|trakteren|uitdelen
ronddolen|rondzwerven|zwerven
ronde|tournee|traject|uitstapje
rondkijken|rondneuzen|rondscharrelen|struinen
rondleiding|tour
rondlopen|rondslenteren|rondwaren
rondneuzen|rondscharrelen|struinen
rondreizen|trekken
rondrit|tour
rondslingeren|slingeren
rondstrooien|uitzwermen|verdeler|verspreiden|verspreider
rondwroeten|snuffelen
ronken|snorren|zagen
rood|stopteken
roodachtig|rossig
rooftocht|strooptocht
rook|walm
room|slagroom
roos|rozenstruik
roosje|rozet
rooskleurig|rozig
rooster|tijdsindeling
rots|rotsblok
rotzak|schoelje|schoft|smeerlap|smiecht
rotzooi|troep
roven|wondkorsten
rover|struikrover
royement|uitsluiting
rozebottel|rozenbottel
rozenhoedje|rozenkrans
ruggegraat|ruggengraat|wervelkolom
ruggemerg|ruggenmerg
ruggengraat|wervelkolom
ruggensteun|ruggesteun
ruggenwervel|ruggewervel|rugwervel
ruggewervel|rugwervel
rui|ruitijd
ruien|verharen
ruigharig|ruwharig
ruil|uitwisseling
ruilen|uitwisselen|verruilen
ruim|weids|wijd
ruimer|wijder
ruisen|suizelen|suizen
ruit|vensterglas
ruitenwisser|ruitewisser|tractor|wisser|trekker
ruitje|vierkantje
rukken|trekken
rukwind|windvlaag
runners|stoepiers
rust|stilte
rusten|toerusten|uitrusten|uitgerust
rusthuis|rustoord
rustpauze|rusttijd
ruziemaker|vechter
saai|slaapverwekkend
saamhorig|solidair
sabel|slagwapen
sabotage|tegenwerking
salaris|traktement|wedde
salarisgroep|salarisschaal
salarisverlaging|verlaging
samenbinden|verbinden
samenhangen|verbanden|zinsverbanden
samenkomst|vergadering|zitting
samenleven|samenwonen|samenwonend
samensmelten|versmelten
samenstelling|samenvoeging
samentrekken|slinken|verschrompelen
samenvatting|uittreksel
samenwerking|samenwerkingsverband
samenwonen|samenwonend
sap|vruchtensap
sarren|tarten|tergen|uitdagen|treiteren|uitlokken
sas|schutsluisje|sluis|verlaat
satire|spotdicht
satisfactie|voldoening
savooiekool|savooienkool
scene|toneel
scepsis|twijfel
schaakstukverplaatsing|zet
schaakzet|zet
schaal|schelp
schaar|schare
schaatsen|schaatsenrijden
schadeclaim|schadevordering
schadeloosstellen|terugbetalen|tevredenstellen
schaduwbeelden|schimmen|spoken|spookbeelden
schaduwen|schimmen
schakel|schalm
schakelklok|tijdschakelaar
schallen|weergalmen
schandmerken|schandvlekken
schapebout|schapenbout
schapenvlees|schapevlees
schatkist|staatskas
schatrijk|steenrijk
schattig|snoeperig|vertederend|snoezig
schede|vagina
scheefte|schuinte
scheepsbouwwerf|scheepswerf|werf
scheepsgezel|varensgezel|zeevaarder
scheepsrecht|zeerecht
scheepsruimte|tonnage
scheepswerf|werf
scheepswerven|werven
scheepswrak|wrak
scheepvaart|zeevaart
scheepvaartroute|zeeroute
scheet|wind
scheidbaar|uitneembaar
scheidrechter|scheidsrechter
schel|schril|snerpend
schelden|uitschelden
schemer|schemerdonker
schemerdonker|schemering|schemerlicht
schemerig|schimmig
schenktuiten|tuiten
schep|schop|spade
scheppen|schoppen|spades
scherf|splinter
scherp|scherpgerand
scherpen|wetten
scherpheid|scherpte|scherpzinnigheid|spitsvondigheid
scherpschutter|schutter
scherpte|scherpzinnigheid|snijkant
scherpzinnig|spitsvondig|uitgekiend
scherpzinnigheid|slimheid|spitsvondigheid
schets|tekening
schetsblok|schetsboek
scheuten|spruiten|stekken
schichtig|schrikachtig|vreesachtig
schieten|vuren
schietpartij|vuurgevecht
schietschijf|schijf
schietspoel|spoel
schietvereniging|schuttersgilde
schiften|selecteren|verzuren|sorteren
schifting|verzuring
schijf|telefoonschijf
schijn|vorm
schijnen|stralen
schilderen|verven
schilderij|schildering|tableau
schildwacht|wacht|wachter
schimmen|spoken|spookbeelden
schitteren|stralen
schlager|succesnummer
schlemiel|sukkel|wat|watje
schoeisel|schoen|schoenen
schoelje|schoft|smiecht
schoenenwinkel|schoenwinkel
schoenlapper|schoenmaker
schoenveter|veter
schoenveters|veters
schoffelen|wieden
schoffie|vlegel|vlerk|vleugel
schoft|schouder
schokken|schokkend
schommelen|wiegen
schommeling|zeegang
schooier|sloeber
school|schoolgebouw
schoolboeken|studieboeken
schoolopdracht|taak
schoolpleinen|speelplaatsen|speelpleinen
schoonborstelen|schoonvegen
schoonmaakster|werkster
schoonmaakwerk|schrobben
schoonmaken|zuiveren
schoonmama|schoonmoeder
schoor|schraag
schoorbalk|steunbalk
schoorsteen|schoorsteenmantel|schouw
schop|spade|trap
schoppen|schoppenmotief|spades
schoren|stutten
schorriemorrie|uitschot
schorsen|suspenderen
schorsing|suspensie
schotten|tussenschotten
schout|schoutendiender
schouwburg|theater
schouwspel|spektakel|spektakelstuk|toneelstuk
schraapmes|schraper
schragen|stutten
schransen|slempen
schraperig|vrekkig
schrede|stap
schreden|voetstappen
schreeuwer|schreeuwlelijk
schrijden|stappen|treden
schrijfmachine|typemachine
schrijfstijl|schrijftrant
schrijfwijze|spelling
schrikbewind|terreur
schrikkelmaand|sprokkelmaand
schroevedraaier|schroevendraaier
schroomvallig|timide
schuchter|timide
schuifknoop|strik
schuiftrompet|trombone
schuilen|toevluchten|uitwijken|wegkruipen
schuilkelder|schuilplaats|stek|toevlucht
schuilplaats|toevlucht|toevluchthaven|vluchtelingenkamp|toevluchtsoord|vrijplaats
schuit|vaartuig
schuiven|voortschuiven
schuldigverklaring|veroordeling|vonnis
schuldvordering|vordering
schutsluisje|sluis|verlaat
schuwen|vermijden
scrotum|zak
seance|sessie
seconde|tel|tellen
secretaresse|secretaris
sectie|vakgroep
sedert|sinds
seiner|seinwachter
selecteren|uitkiezen|uitpikken
selectie|uitverkoring
sensationeel|spannend|zinderend
sensibiliseren|sensibilisering
sensorisch|zintuiglijk
sensueel|wulps|zinlijk
sereen|vredig
sering|seringenboom
serpent|slang|tuinslang
serpenten|slangen
servet|vingerdoekje
serviel|slaafs
settelen|vestigen
sextet|zestal
shampo|shampoo
shot|slok
show|vertoning|voorstelling
sieraad|sierstuk
sieraden|sierraden
simultaan|tegelijk|tegelijkertijd|teglijktijdig
singel|stadsgracht
sip|teleurgesteld|verdrietig
site|webpagina
sjablone|sjabloon
sla|slaatje
slaapgelegenheid|slaapplaats
slaaploos|slapeloos
slager|vleeshouwer
slagzin|slogan
slagzinnen|slogans
slak|slome|sukkel|treuzelaar
slakkehuis|slakkenhuis
slang|sproeier|tuinslang|waterslang
slap|slapjes|waterachtig|week|waterig|zwak
slapjanus|slappeling
slechtheid|verdorvenheid
sleden|slee
slet|snol
sleutel|tool
slijpen|wegslijpen|wetten
slijper|slijpmachine
slim|snugger
slimheid|spitsvondigheid
slimmigheid|vernuft
slingeren|wuiven|zwaaien
slok|teug
slome|treuzelaar
sloot|vaart|watergang
sluier|voile
sluikhandel|smokkelen
sluimer|sluimeren
slurpen|zuigen
smaak|smaakwaarneming
smaakvol|stijlvol
smachtend|verlangend
smakeloos|stijlloos
smeekbede|verzoek
smeergeld|steekpenning
smeergelden|steekpenningen
smeerkaas|smeltkaas
smeerlap|viezerik|zwijn
smiespelen|smoezen|voorwendsels
smikkelen|smullen
smoes|uitvlucht|voorwendsel
smoezen|voorwendsels
snauwen|toesnauwen
snavel|vogelbek
snede|snee|snijwond
sneetje|snijwondje
sneeuw|sneeuwen
snelheid|tempo|vlugheid
snipperdag|vakantie|verloftijd|verlof
snipperen|versnipperen
snippers|spaanders
snoeien|trimmen
snoeischaar|snoeitang
snoepgoed|snoepjes|versnapering|zoetigheid
snotaap|snotneus
snuit|tronie
snuiver|tabaksnuiver
socialisatie|vermaatschappelijking
soda|sodawater|spuitwater
sodawater|spuitwater
sokkel|voetstuk|zuilvoet
somber|verdrietig|zwaarmoedig
soms|somwijlen
sopraan|zanger
souffleur|voorzegger
sowieso|toch
spa|spawater
spaarcentjes|spaargeld|spaartegoed
spaarpot|spaarvarken
spaarvlam|waakvlam
spaarzaamheid|zuinigheid
spaarzegel|zegel
spankracht|veerkracht
spannend|synoniem
spanners|steeksleutels
spanning|strakheid
spanningsmeter|voltmeter
spar|sparreboom|sparrenboom
sparen|verzamelen|zamelen
spatten|spetteren
specialisatie|specialisme|vakgebied
specialisme|vakgebied
specificeren|specifieren
specimen|staaltje
speeksel|spuug
speelduur|wedstrijdduur
speelruimte|speling
speelveld|sportgebouw|stadion
speerpunt|voorhoede
spekglad|spiegelglad
spelers|toneelspelers
sperma|zaad
spiegeling|weerspiegeling
spier|spierbundel
spieren|spierstelsel
spierwit|wit
spijkeren|timmeren|vastslaan
spijl|stijl|tralie
spijsvertering|vertering
spijsverteringen|verteringen
spinnenweb|spinneweb|spinrag|web|spinsel
spinsel|web
spits|spitsuur|vleugelspeler
spitsen|spitsuren
spitsvondig|uitgekiend
spitsvormig|toegespitst
splijten|splitsen
spoedeisend|urgent
spoedkarwei|spoedklus|spoedopdracht
spoelen|wegspoelen
spoorbaan|spoorweg
spoortrein|trein
spoorwagen|spoorwagon|wagon
spoorwegwissel|wissel
sporadisch|zeldzaam
sporen|treinen
sportauto|sportwagen
sportvisser|visser
spotlight|zoeklicht
spraakkunst|spraakleer
sprint|spurt
sproeier|tuinslang
sprookje|sprookjesverhaal|verzinsel
spruiten|voortspruiten
spuitbus|verstuiver
spuiten|uitspuiten
sputteren|tegensputteren
staartstuk|stuit
staatsinrichting|staatsvorm
stadbewoner|stedeling
stads|stedelijk
stadsdeel|stadswijk
stadswijk|wijk|woonwijk
stagnatie|stilstand|stuwing
staken|staking|werkonderbreking|werkstaking
staking|werkonderbreking|werkstaking
stalen|verharden
stam|stamvorm|volksstam
stamboek|stamboom
stamelen|stotteren
stammen|volksstammen
stampei|tamtam
standhouden|volharden
standplaats|taxistandplaats
standvastig|vastberaden
standvastigheid|vastberadenheid
star|strak
starheid|stugheid
starten|stichten
startpunt|uitgangspositie|uitgangspunt|vertrekpunt
startschot|startsein
statig|waardig
steekcontact|stekker
steekkar|steekwagen
steekwoorden|trefwoorden
steekzakken|zakken
steel|stengel
stelsel|systeem
stelselmatig|systenatisch
stempelen|stempeling
sterfgeval|sterfte
sterken|versterken
sterrenkijker|telescoop
stervensbegeleiding|vuilnisbak
steun|steunpilaar|toeverlaat
steunpaal|volksgroepering|zuil
steunpilaar|toeverlaat
stijf|stram|stug
stijfhoofd|stijfkop
stil|stilzwijgend
stilaan|zwijgend
stillegging|stopzetting
stipendium|studiebeurs
stippel|vlek
stochastiek|toeval|toevalligheid
stoelen|zetels
stoep|trottoir|voetpad
stoeprand|trottoirband
stof|stofdeeltjes
stoffeerderij|stoffering
stoffer|veger
stofje|vuiltje
stokken|stremming|wandelstokken|stuklopen|vastlopen
stomen|uitwasemen
stomp|stronk
stompen|stoten
stoof|voetenwarmer
stoomboot|stoomschip
stoomwals|wals
stoomwalsen|walsen
stoornis|verstoring
stop|zekering
stopcontact|wandcontactdoos
stoplicht|verkeerslicht
stoppen|uitvallen
stormwind|wind
storneren|terugboeken
stortgat|stortkoker
stouwer|stuwadoor
straatjongen|vandaal
straatreiniger|veegmachine
straffeloos|vrij|vrijuit
strafrecht|strafwet
strafuitvoering|terechtstelling
strak|strakgespannen
stram|stroef
strand|zandstrand
strategie|tactiek
strategisch|tactisch
streling|vleien
stremming|vastlopen
strijd|uitblinker|vedette
strijden|vechten
strijdlustig|vechtlustig
strijdmiddel|wapen
strikje|vlinderdas|vlinderdasje
strip|stripverhaal|strook
stroef|stug
strohalm|strootje
stromend|vliedend|vloeiend|vlot
strooibus|strooier
strook|volant
stroperig|taai-vloeibaar
struiken|struikgewas
struis|struisvogel|zwaargebouwd
stucadoren|stukadoren
stucwerker|stukadoor
studeer|studeren
studeerkamer|werkkamer
studentenbond|studentencorps|studentenvereniging
studentencorps|studentenvereniging
studententijd|studietijd
stuiten|stuitjes|terugkaatsen
stuklopen|vastlopen
stukmaken|verbreken|verpesten
stukslaan|verbreken|verbrijzelen|vermorzelen
sturen|zenden
stuur|stuurwiel
stuurhuis|stuurhut
stuwen|voortstuwen
subliem|voortreffelijk
subsidie|toelage
substitutie|vervanging
succes|welslagen
succesnummer|topper
suikerachtig|suikerig
suizelen|suizen
sun|zon
suppoost|zaalwachter
supporters|volgers
surfen|windzeilen
surprise|verrassing
surrogaat|vervanging
surveillant|zaalchef
taaiheid|uithoudingsvermogen|volharding
taakverdeling|werkverdeling
taalbeheersing|taalvaardigheid
tab|tabulator
takje|twijg
takkewijf|troela|trut
talmen|treuzelen
talrijkheid|veelheid
tandaanslag|tandplak
tanden|uittanden
tandrad|tandwiel
tank|waterreservoir
tankauto|tankwagen
tap|tapkast
tapijt|vloerbedekking|vloerkleed
tapkast|toog|toonbank
tassen|zakken
tasten|voelen
taxatie|waardebepaling
tearoom|theesalon
teder|teer
teef|wijfjeshond
teelbal|testikel
teelt|veefokkerij|verbouw|verwekking|voortplanting|voortbrenging
teenager|tiener
tegel|tegeltje
tegemoet|tegen
tegemoetzien|verwacht|verwachten|vooruitzien
tegenbewijs|weerlegging
tegenprestatie|wederdienst
tegenspartelen|tegenstribbelen|verplaatsen|verzetten
tegenspreken|tegenwerpen|weerspreken
tegenwerking|weerstand
tegoedbon|waardebon
teil|vat
telefonie|telefoonbedrijf|telefoondienst
telefonist|telefoniste
telefoon|telefoontoestel
telefoonaansluitingen|telefoonlijnen
telefoonbedrijf|telefoondienst
telefoonboek|telefoongids
telefoonkosten|telefoontarief
telen|verbouwen
televisie|televisietoestel|tv
telex|telextoestel
tempelier|tempelridder
tendens|trend
tendentieus|vooringenomen
tenietdoen|vernietigen|verwoesten
tennisbanen|tennisvelden
tentoonspreiden|uitstallen
tenuitvoerlegging|uitvoering|volbrengen|voltrekking|voltooien
tenuitvoerleggingen|uitvoeringen
tenzij|uitgezonderd
teraardebestelling|uitvaart
terechtwijzing|verwijt
terugbekomen|terugkrijgen
terugdrijven|terugdringen
terughalen|terugroepen
terugkaatsen|weergalmen|weerkaatsen|weerschijnen
terugreizen|terugrijden
terugslaan|terugvechten
terugslag|terugstoot|weerslag
terugstromen|terugvloeien
terugwijzen|wegstemmen
testament|wilsbeschikking
testen|toetsen|uitproberen|uittesten
tevens|voorts
tevergeefs|vergeefs
textiel|textielwaren|weefsel
theelepel|theelepeltje
theezeefjes|zeven
thermosfles|thermoskan
these|thesis
thuisbasis|thuishonk
thuisland|vaderland
ticket|toegangsbewijs
tiet|vrouwenborst
tijd|tijdstip
tijdbesparing|tijdwinst
tijdelijk|vergankelijk|zolang|voorbijgaand
tijdperk|tijdvak
tijdschrift|weekblad
timide|verlegen
titel|waardigheidstitel
titelblad|titelpagina
tobbe|waskuip
toch|weliswaar
toebedelen|toekennen|toewijzen|vergunnen
toegelicht|uitgelegd
toegrijpen|toetasten
toekenning|toewijzing|verlening
toelichten|verduidelijken
toen|waarna
toename|verhoging|verrijking|versterking|versteviging
toenames|toenemingen
toeneigen|wazen|zwemen
toenmalig|voormalig
toepasbaarheid|toepasselijkheid
toer|trip
toerekeningsvatbaar|verantwoordelijk
toerisme|vreemdelingenverkeer
toerist|vakantieganger|vakantiereiziger
toernooi|tornooi|wedstrijd
toerusten|uitgerust|uitrusten
toerusting|uitrusting
toespelen|zinspelen
toespeling|verwijzing
toeval|toevalligheid
toeven|verwijlen
toevluchten|uitwijken|wegkruipen|vertrekken|wegvluchten
toevluchthaven|vluchthaven
toevoermechanisme|veevoer|voeder
toewijding|zorgzaamheid
toewijzing|verlening
tol|wegenbelasting
tolerantie|verdraagzaamheid
tonaliteit|toonsoort
tonen|voorbinden|voordoen|voorvallen
tong|tongschar
tongen|tongzoenen
tonnen|vaten
tonnetje|vaatje
toonbaar|vertoonbaar
topconferentie|topontmoeting
topjes|toppen
toren|torentje
torengebouw|wolkenkrabber
tornado|wervelstorm
torsie|wringing
tot|totdat
touwtrekken|touwtrekkerij|worstelen
toxine|vergif
traan|walvistraan
tractie|trekkracht
tractor|trekker
traditiegetrouw|traditioneel
tragedie|treurspel
trans|zuilengang
transformatie|vormverandering|wijziging
translateren|vertalen
transpiratie|transpireren|zweet|zweten
transpireren|zweten
transport|vervoer|vrachtvervoer|wegtransport
transportbedrijf|vervoersbedrijf
transporteur|vrachtondernemer
transportkosten|vervoerskosten
transportmiddel|vervoermiddel
trap|trapje
trapleuning|trapleuningen
trappenhuis|trapportaal
traptrede|trede|tree
traptreden|treden
trauma|verwonding
treden|voetstappen
trefwoordenregister|zoeklijst
trekken|voorttrekken
trekker|trekster
trekkers|wandelaars
tremor|trilling|vibratie
treurig|verdrietig
trillen|vibreren
trillend|vibrerend
trilling|vibratie
triomf|zegepraal
triplex|triplexhout
troef|troefkaart
troela|trut
trog|voedertrog
trom|trommel
troonopvolger|troonpretendent
troosten|vertroosten
troostend|vertroostend
trottoir|voetpad
trouwboek|trouwboekje
trouwjapon|trouwjurk
truc|trucage
tuinbouwer|tuinder
tuinhek|tuinpoort
tuinier|tuinman
tuinslang|waterslang
tunica|tuniek
tunnel|voetgangerstunnel
turbulent|veelbewogen
turbulentie|werveling
turf|turfveen|veen|veengrond
turfveen|veen|veengrond
Turk|interventies
tussendoortje|vluggertje
tweedelig|tweeledig|tweevoudig
tweedracht|tweespalt|vete|verdeeldheid
tweeledig|tweevoudig
tweeverdiener|tweeverdieners
uitademen|uitblazen
uitbannen|uitwijzen|verbannen|verdrijven|verjagen|wegdrijven|voortdrijven|wegjagen
uitbarsting|vulkaanuitbarsting|woede-aanval
uitbeelden|verbeelden|verpersonificeren|vertolken
uitbesteden|uitbesteed
uitblinken|uitmunten
uitblinker|vedette
uitbreiding|uitvergroting|uitzetting|vergroting
uitbrullen|uitroepen|uitschreeuwen
uitbuiken|uitzakken
uitbundig|uitgelaten
uitdenken|uitkienen|uitknobbelen|verzinnen
uitdijen|uitzwellen
uitdrogen|verdorren|verdrogen|verwelken
uitdruipen|uitlekken
uiteengerafeld|uitgeplozen
uiteenlopen|vari
uiteenzetten|uitleggen|vertellen
uiterlijk|uitwendig
uitfoeteren|uitkafferen|uitschelden
uitgebreidheid|uitgestrektheid
uitgedrukt|uitgeknepen
uitgelezen|voortreffelijk
uitgeschreven|voluitgeschreven
uitgestorven|verlaten
uitgestoten|verstoten
uitgevallen|wegvallen
uitgever|uitgeverij|verspiller
uitgevoerd|verricht
uitglijden|verzwakken|wegglijden|wegzinken
uitgooien|uitwerpen
uithalen|uitspoken|uittrekken
uitheems|vreemd|vreemdsoortig
uithouden|volharden|volhouden
uithouding|volharding
uitje|uitstapje|wandeling
uitkienen|uitknobbelen
uitkijkpost|waarnemingspost
uitkijktoren|wachttoren
uitlaat|uitlaatklep|uitlaatpijp|vlampijp
uitlaatgas|uitlaatgassen
uitlaatpijp|vlampijp
uitlegger|verklaarder
uitlegging|verbreiding
uitmatch|uitwedstrijd
uitmuntend|volmaakt|voortreffelijk
uitrekenen|uitwerken
uitrekken|verlengde|verlengen
uitroeien|verdelgen|wegvagen
uitroeiing|verdelging
uitroepen|uitschreeuwen
uitrukken|uitscheuren
uitschakelen|uitzetten
uitscheiden|wijken|zwichten
uitscheiding|uitwerpselen
uitslag|uitsluitsel
uitspugen|uitspuwen
uitstippelen|uitzetten
uitstoot|uitstoting
uitvallen|wegvallen
uitvergroting|vergroting
uitverkiezen|verkiezen
uitverkocht|volgeboekt
uitvlakken|wissen
uitvoerder|vertolker
uitvoerig|vliet
uitwaseming|wasem
uitwringen|wringen
uitwuiven|uitzwaaien
uitzakking|verzakking
uitzicht|vergezicht
uitzwermen|verspreiden
uitzweten|zweten
urbanisatie|verstedelijking
urineren|wateren
vaan|vaandel
vaandel|vendel|vlag
vaantje|vlaggetje
vak|vriesvak
vakantie|verlof|verloftijd|vrijaf
vakarbeid|vakmanschap|vakwerk
vakbekwaamheid|vakkennis
vakblad|vaktijdschrift
vakbond|vakcentrale|vakvereniging|werknemersorganisatie
vakleraar|vakonderwijzer
vakmanschap|vakwerk
vals|valselijk
vandalisme|vernielzucht
vanille-ijs|vanilleijs
vanmorgen|vanochtend
vanwege|wegens
varen|zeildoeken|zeilen
varensgezel|zeevaarder
varken|vuilbek|zwijn
varkens|viezeriken|zwijnen
varkensachtig|zwijnachtig
vastberadenheid|zekerheid|zelfvertrouwen|zelfverzekerdheid
vastbinden|vastsjorren
vastgrijpen|vastpakken
vastkluisteren|vastleggen
vastpinnen|vastprikken
vee|veestapel
veebedrijf|veehouderij
veelvraat|vreetzak
veerboot|veerdienst
veevoer|voeder|voer
vehicle|voertuig
veiling|verkoping
vendelzwaaien|vlaggen
venijn|venijnigheid
venijnigheid|virulentie
ver|veraf|verafgelegen
verafschuwen|verfoeien
veranderingen|wendingen
verantwoord|verantwoorden
verassen|verbranden
verbaasd|verbouwereerd
verband|zwachteling
verbanden|zinsverbanden|zwachtels
verbasteren|vervormen
verbazen|verwonderen
verbazend|verbazingwekkend
verbazing|verwondering
verbazingwekkend|verrassend|verwonderend|verwonderlijk|wonderbaar|wonderbaarlijk|wonderlijk
verbeelden|verpersonificeren
verbeeldingskracht|voorstellingsvermogen
verbergen|verduisteren|verhullen|versluieren
verbeten|verkropt
verbetering|vooruitgang
verbeuzelen|vergallen|verknoeien|verpesten
verbijsteren|verwonderen
verbijten|verkroppen
verbintenis|verplichting
verbittering|wrok
verbleken|vervagen
verblijfsvergunning|visum
verblijven|wonen
verblind|verdwaasd
verboden|wederrechtelijk
verbrand|verschroeid
verbranding|verbrandingsproces
verbrassen|verdoen|verhandelen|verkopen|verkwisten|verspillen
verbreding|verwijding
verbrijzelen|vergruizen|vermorzelen|verpletteren
verbroedering|verzoening
verbrokkelen|verkruimelen
verbruikt|verteerd
verbuigen|vervoegen
verdedigen|verweren|verwering
verdediging|verweer|verweerschrift
verdeel|verdelen|verkavelen
verder|voorts
verdichten|verzinnen
verdichting|verzinsel
verdoemen|vervloeken
verdoen|verspillen
verdonkeremaning|verduistering
verdonkeren|verduisteren
verdorren|verleppen|verwelken
verdraaid|verduiveld|verwrongen
verdrijven|verjagen|wegdrijven|wegjagen
verdronken|verzopen
verdubbelen|vermenigvuldigen|verveelvoudigen|voortplanten
verduidelijken|verhelderen
verduistering|zonsverduistering
verdwijnen|wijken
veredelen|verfijnen
vereenvoudigen|vergemakkelijken
vereisen|vergen
verenigen|verzamel|verzamelen
verflauwen|verslappen
verfrissen|verkwikken
verfrommelen|verkreukelen
vergaan|zinken
vergankelijkheid|vluchtigheid
vergaren|verzamelen
vergeetachtigheid|vergetelheid
vergelden|wreken
vergeleken|vergelijken
vergeven|weggeven
vergeving|vergiffenis
vergiet|zeef|zever
vergiffenis|verontschuldiging|verschoning
vergoeilijken|vergoelijken
vergokken|verspelen
vergrijzing|veroudering
vergruizen|vermorzelen
vergruizing|versnippering
vergunnen|verlenen|verstrekken
verhaal|vertelsel
verhaaltje|vertelsel
verhalen|vertellen
verhandelen|verkopen
verhandeling|werkstuk
verharding|versteviging
verhelen|verzwijgen
verheug|verheugen
verhoeden|vermijden
verhuizen|verkassen
verhuizing|verplaatsing
verjaardag|verjaring
verjaardagsfeest|verjaarspartij
verkeersbord|verkeersteken
verkeersongeluk|verkeersongeval
verkenner|verkenningsvliegtuig
verkering|vriendje
verkikkerd|verliefd
verkleden|vermommen
verkleinen|verminderen
verklikken|verlinken|verraden
verklungelen|verpesten
verknallen|verpesten
verkoop|verkoper
verkoopster|winkelbediende
verkorten|verminderen
verkwisting|verspilling
verlamdheid|verlamming
verlangen|wensen|willen
verleiding|verlokking|verzoeking
verleppen|verwelken
verlichting|verzachting
verlijeren|wraken
verloedering|verwaarlosing
verlof|verloftijd
verloochenen|verzaken|verzuimen
verloochening|zelfverloochening
verloskundige|vroedvrouw
verlossen|vrijmaken
vermaak|vertier
vermanen|waarschuwen
vermaning|waarschuwing
vermenigvuldigen|verveelvoudigen|voortplanten
vermijden|vermijding
vermoed|vermoeden
vermorzelen|verpletteren
vernauwen|versmallen
vernevelen|verstuiven
vernieler|verwoester
vernietigend|verwoestend
veronachtzaming|verwaarlozing|verzaking
verontreinigen|vervuilen
verontreiniging|vervuiling
verontwaardiging|verstoordheid
verorberen|verorbering
verpersonificatie|vertolking
verpersonificeren|vertalen|vertolken
verpesten|verzieken
verplaatsbaar|vervoerbaar
verplaatsen|verrijden|verschuiven
verpleeghuis|verpleegtehuis
verpleegkundige|verpleger
verpleegster|zuster
verpleegtehuis|verzorgingstehuis
verplegen|verzorgen
verpozing|verzetje
verrijzenis|wederopstanding
verrukt|zielsgelukkig
vers|versgebakken|versregel
verschaffen|verstrekken
verschaffing|voorziening
verscheping|vervoer
verschijning|verschijningsvorm
versiering|versiersel
verslaafdheid|verslaving
verspreid|verstrooid
verstandig|zinnig
verstarren|verstenen
verstelgoed|verstelwerk
verstillen|verstommen
verstreken|voorbij
verstrengeling|vervlechting
verstuiving|zandverstuiving
versturen|verzenden
vertakking|zijtak
vertegenwoordigd|vertegenwoordigen
vertellen|zei
vertoeven|verwijlen
vertroetelen|verwennen
vervaldag|vervaldatum
verveeld|vervelen
vervlechten|verweven
vervloeking|verwensing
vervoerder|vrachtondernemer
vervolg|voortzetting
vervolledigen|vervolmaken
vervriendelijken|verzachten
verwaarlozen|wegcijferen
verwacht|verwachten
verwachten|vooruitzien
verwedden|wedden
verwekking|voortbrenging
verwensing|vloek
verwerk|verwerken
verwerkelijken|verwezenlijken
verwerken|verwerkt
verwerping|weigering
verwijderen|wegdoen
verwijsbrief|verwijzing
verwondingen|wonden
verzadigd|vol|voldaan|volgegeten
verzengen|zengen
verzet|verzetsbeweging
verzinken|verzinking
verzuchting|zucht
vesting|vestingsgracht
vet|vettig
vezel|vezeldraad
vier|viertal
viezerik|vuilbek|zwijn
vijandelijk|vijandig
vijandelijkheid|vijandigheid
vijgeboom|vijgenboom
vijlsel|vijlspaan
vin|zwemvlies
violist|vioolspeler
vioolbloempjes|viooltjes
visaas|visvoer
visfuik|visnet|vistuig
visgerei|visnet|vistuig
vissen|visvangen
visserij|visvangst
vlaggemast|vlaggenmast|vlaggenstok
vlaggenmast|vlaggenstok
vlechtsel|vlechtwerk
vlek|vlekje
vlekkeloosheid|zuiverheid
vlerk|vleugel|wiek
vleugel|wiek
vlieden|vluchten|wegvluchten
vliedend|vloeiend
vliegemepper|vliegenmepper
vliegend|zwevend
vliegmachine|vliegtuig
vliegreis|vliegtocht|vlucht
vliegroute|vluchtroute
vlinderdas|vlinderdasje
vloeistof|vocht|vochtigheid
vloeroppervlak|vloeroppervlakte
vloot|zeevloot
VN|Veiligheidsraad
vocabulaire|woordenlijst|woordenschat
vocaliste|zangeres
vod|vodje
voedering|voering
voedingsmiddel|voedingsproduct
voet|voetbeen
voetbalclub|voetbalvereniging
voetbalpool|voetbaltoto
voetensteun|voetsteun
voetstuk|zuilvoet
voettocht|wandeling|wandeltocht
voetwreef|wreef
vogelhuis|vogelhuisje|voli
volbrenging|voltooiing
voldoen|voldoet|volstaan
volgeling|volger
volgooien|vullen
volgroeid|volwassen
volksgroepering|zuil
volleybal|volleybalspel
volmaken|volstorten|voltooien|vullen
volproppen|volstoppen|volvreten
volschenken|vullen
volstoppen|volvreten
volzinnen|zinnen
voogdij|voogdijschap|zeggenschap
voor|voordat
voorafgaan|vooropgaan
voorbespreking|voorverkoop
voorbinden|voordoen
voorbode|voorloper|voorteken
voordien|voorheen|voormalig|vroeger
voorgeslacht|voorouders
voorkeur|voorliefde
voorkeuren|voorliefdes
voorlichter|woordvoerder
voorlopen|vooroplopen|vooruitlopen
voormalig|voormalige
voorn|voren
vooroplopen|vooruitlopen
vooropstellen|vooropzetten
voorrad|voorwiel
voorslaan|voorstellen
voorspellen|voorzien|wichelen
voortdrijven|wegjagen
vooruitgaan|vorderen
vooruitspringen|vooruitsteken
vos|vrouwtjesvos
vrachtauto|vrachtwagen
vrachtvervoer|wegtransport
vragend|vragenderwijs
vredelievend|vreedzaam
vreemdelingendienst|vreemdelingenpolitie
vroeg|vroegtijdig
vrolijk|zonnig
vrouwmens|vrouwspersoon
vruchtbaar|winstgevend
vulcaniseren|vulkaniseren
vulsel|vulstof
waak|wake
waakzaam|wakend
wachtkamer|wachtlokaal
wal|waterkant
wandelpad|wandelweg
wandkleed|wandtapijt
warhoop|warwinkel
was|wasgoed
wasmiddel|waspoeder|zeeppoeder
waspoeder|zeeppoeder
wat|watten
waterachtig|waterig
waterhoogte|waterpeil
waterval|watervallen
wazen|zwemen
we|wij
webmaster|websitebeheerder
webpage|webpagina
website|webstek
wederkerig|wederzijds
wederkerigheid|wederzijdsheid
wedloop|wedren
weekeinde|weekend
weerbericht|weersverwachting|weersvoorspelling
weerkaatsen|weerschijnen|weerspiegelen
weersgesteldheid|weersomstandigheden
weersverwachting|weersvoorspelling
wees|weeskind
wegdringen|wegdrukken|wegduwen
wegdrukken|wegduwen
wegstoten|wegtrappen
wei|weide|weiland
weide|weiland
weiden|weilanden
wel|welnu
weldoordacht|weloverwogen
welgesteld|welvarend
welker|wier
wellevend|welopgevoed
welstand|welvaart
wemelen|wriemelen
wens|wil
wensen|willen
werd|worden
werk|werkgelegenheid
werkkleding|werkpak
werkkring|werkplek
werklieden|werklui
werkloosheidsuitkering|ww
werkmethode|werkwijze
werktijd|werktijden
wervelen|wielen
wervelstorm|wervelwind
wespensteek|wespesteek
west|westelijk
wetsontwerp|wetsvoorstel
wilddief|wildstroper
winkel|winkelzaak|zaak
winkelbediende|winkelmeisje
winkelwagen|winkelwagentje
winnen|zegevieren
winstdeling|winstuitkering
wissel|wisselbrief
wisselend|wisselvallig
witte|witten
woelen|wroeten
wonen|woon
woning|woonhuis
woninginrichting|woninginstallatie
woongemeenschap|woongroep
worden|wordt
wraak|wraakneming
wraaklustig|wraakzuchtig
wriggelen|wrikken
wuiven|zwaaien
wulps|zinlijk
WW|uitkering
zakkenrollen|zakkenrollerij
zaklamp|zaklantaarn
zal|zou|zullen
ze|zij
zedendelict|zedenmisdrijf
zeegevecht|zeeslag
zeegras|zeewier
zeehond|zeerob
zeehonden|zeerobben
zeeniveau|zeespiegel
zeikerd|zemel|zeurkous|zeur
zeilboten|zeilschepen
zeildoeken|zeilen
zelfbesef|zelfbewustzijn
zelfbewustheid|zelfvertrouwen|zelfverzekerdheid
zelfhechtend|zelfklevend
zemel|zeurkous
zemelen|zeuren
zender|zendinstallatie
zetten|zetwerk
zeug|zeugen
zeur|zeurkous
zeurkous|zeurpiet
zich|zichzelf
ziektekostenverzekering|ziekteverzekering
zielszorger|zielzorger
zinsbedrog|zinsbegoocheling
zo'n|
zodanig|zulk
zoet|zoetsmakend
zoeten|zoetmaken
zoiets|zulk
zojuist|zo
zonet|zo
zorgenkind|zorgenkindje
zou|zullen
zouden|zullen
zout|zoutig
zulk|zulke
zus|zuster
zwemmen|zwemsport
