a cerca de|a respeito de|sobre
a começar de|a partir de|desde
à excepção de|além de|excepto|fora|salvo
a favor|em prol
à frente|adiante|avante|primeiro
ab-rogar|abortar|anular|cancelar|cassar|derrogar|eliminar|infirmar|invalidar|rescindir
ababelado|atarantado|atrapalhado|baralhado|desnorteado
ababelar|atrapalhar|baralhar
abaçanado|amorenado|bronzeado|escuro
abaçanar|amorenar|escurecer
abadessa|prelada|prioresa|superiora
abadia|ádito|basílica|catedral|convento|igreja|mosteiro|presbitério|santuário|sé
abafação|abafação|abafação|abafamento|ocultação|asma|sonegação|sufocação
abafadiço|abafante|asfixiante|sufocante
abafado|abafado|abafado|abafado|abafado|abafado|abafado|abrasado|asfixiado|empalmado|abrasado|sufocado|escamoteado|agasalhado|furtado|aquecido|larapiado|rapinado|roubado|surripiado
abafar|abafar|abafar|abafar|abafar|abafar|abafar|abrasar|arrebatar|dominar|agasalhar|empalmar|subjugar|aquecer|escamotear|vencer|furtar|larapiar|rapinar|roubar
abafo|agasalho
abaixado|acabrunhado|achatado|achatado|aperreado|humilhado|oprimido|vexado
abaixamento|abatimento|abatimento|abatimento|abatimento|depressão|humilhação
abaixar|agachar|arriar|baixar|descair|descer
abaixo|aquém|inferior
abaixo-assinado|petição|requerimento|solicitação|subscrição
abajur|lucivelo|pantalha|quebra-luz
abalada|partida|saída
abaladiço|bambo|flácido|frouxo|inseguro|instável|lasso|oscilante|suxo|vacilante
abalado|aluído|comovido|exitante|impressionado|inseguro
abalançar|compensar|contrabalançar|equilibrar|igualar
abalar|abalar|abalar|combalir|fugir|elanguescer|partir|enfraquecer|zarpar
abalizado|abalizado|abalizado|balizado|competente|demarcado
abalizador|ajuizador|avaliador|censor|crítico
abalizar|abalizar|abalizar|assinalar|balizar|distinguir|delimitar|marcar|demarcar|limitar
abalo|abalo|abalo|abalo|abalo|abalo|abalo|abalo|abalo|abalo|abalo|abalo|abalo|alvoroço|comoção|sismo|tremor|alvoroço|emoção|terremoto|trepidação|espavento|surpresa|susto
abalroa|arpão|arpéu|balroa|fateixa|fisga
abalroação|abalroamento|choque|colisão|embate|encontro
abalroador|abalroante
abalroados|abordados
abalroar|abalroar|abalroar|aferrar|bater|ancorar|chocar|aportar|colidir|arpar|embater|atracar|esbarrar
abanação|abanadela|agitamento|balanço|nutação|oscilação|sacudidela
abanão|solavanco|tranco
abanar|agitar|sacudir|vibrar
abancar|assentar|sentar
abandonado|abandonado|abandonado|desabitado|desprezado|deserto|esquecido|despovoado|ignorado|ermo|menosprezado|posposto
abandonar|abandonar|abandonar|ceder|desabitar|deixar|despovoar|desistir|largar
abandono|abandono|abandono|abandono|abandono|abandono|abandono|desabrigo|descuramento|deserção|desamparo|desleixo|desistência|desarrimo|orfandade
abanico|abano|flabelo|leque|ventana|ventarola
abarbado|abarrotado|abarrotado|abarrotado|assoberbado|atarefado|atulhado|azafamado|sobrecarregado
abarbar|atingir|nivelar|sobrecarregar
abarbarar|abrutalhar|asselvajar|barbarizar|bestializar|bestifícar|brutalizar|embrutecer
abarcado|açambarcado
abarcador|abarcador|abarcador|abarcante|açambarcador|açambarcador|açambarcador|açambarcador|atravessador
abarcamento|açambarcamento
abarcar|abraçar|abranger|envolver
abarracamento|acampamento|aquartelamento|bivaque
abarroado|abarroado|abarroado|abrutalhado|caprichoso|asselvajado|casmurro|descortês|contumaz|fúfio|marroaz|grosseiro|obstinado|incivil|pertinaz|incivilizado|pirrónico|indecente|teimoso
abarrotado|abarrotado|abarrotado|abarrotado|abarrotado|atestado|carregado|cheio|completo|farto|lotado|repleto
abarrotar|assoberbar|atestar|atulhar|encher
abastadamente|abundantemente|excessivamente|fartamente|sobejamente
abastado|abastado|abastado|abonado|endinheirado|afiançado|opulento|recheado|rico
abastamento|abastança|abundância|abundância|cópia|fartura
abastar|abastecer|aprovisionar|fornecer|guarnecer|munir|prover|rechear|sortir
abastardado|adulterado|alterado|alterado|alterado|alterado|contrafeito|corrompido|degenerado|deturpado
abastardamento|adulteração|contrafacção|deturpação|falsificação
abastardar|abastardar|abastardar|adulterar|estragar|corromper|piorar|depravar|desnaturar|viciar
abastecedor|fornecedor|provisor
abastecido|fornido|provido
abastecimento|aprovisionamento|fornecimento|provimento|provisão
abatatado|achatado|achatado|amassado|amolgado
abatatar|abolar|achatar|amassar|amolgar|deformar
abater|abater|abater|abater|abater|abater|abater|amesquinhar|atrofiar|bater|derribar|debilitar|derrotar|derrubar|deprimir|profligar|derruir|vencer|desmoronar|esboroar|humilhar
abatido|abatido|abatido|alquebrado|aniquilado|alquebrado|arruinado|anémico|destruído|debilitado|fraco|langoroso|lânguido|quebranto
abatimento|abatimento|abatimento|abatimento|abatimento|abatimento|abatimento|abatimento|abatimento|abatimento|consternação|dedução|desanimo|desalento|desconto|esmorecimento|tristeza|diminuição|languidez|tristura|melancolia|misantropia|prostração
abaulado|arredondado|boleado|convexo|torneado
abaular|arredondar
abc|abecedário|alfabeto|princípios|rudimentos
abcesso|apostema|fleimão|inchação|inchaço|intumescência|intumescimento|polmão|proeminência|tumefacção
abdicação|desistência|renunciação|resignação
abdicar|abdicar|abdicar|abjurar|declinar|apostatar|desaceitar|perjurar|negar|resignar|recusar|rejeitar|renegar|renuir|renunciar
abdicável|demissível|renunciável
abdome|abdómen
abdominoso|barrigudo|obeso|pançudo|ventrudo
abduzir|abduzir|abduzir|abrir|arrancar|abrir|extractar|afastar|extrair|afastar|exturquir|desviar|puxar|distrair|sacar|tirar
abeberar|dessedentar|saciar
abeirado|abordado|aportado|aproximado
abeiramento|aproximação|avizinhamento
abeirar|acercar|aproximar|avizinhar
abelha|abelhão|zangão
abelheiro|apicultor
abelhudice|bisbilhotice
abelhudo|atrevido|curioso|descarado|insolente|intrometido|metediço
abençoadeira|benzedeira|curandeira
abençoado|bendito|ditoso|venturoso
abençoar|abençoar|abençoar|bendizer|benzer|gloriar|sagrar|glorificar|louvar|ufanar
aberração|anomalia|anormalidade
aberrante|anómalo|anormal|defeituoso
aberta|ensejo|ocasião|oportunidade
abertamente|claramente|francamente
aberto|aberto|aberto|aberto|aberto|aberto|aberto|acessível|cândido|descerrado|acessível|crédulo|destapado|desimpedido|franco|desobstruído|ingénuo|lhano|simples|sincero
abertura|abertura|abertura|abertura|abertura|abertura|abertura|brecha|exórdio|franqueza|buraco|início|lhaneza|fenda|introdução|lisura|orifício|preâmbulo|sinceridade|rombo
abespinhado|irado|iroso|irritado|raivoso|revolto|tempestuoso|zangado
abespinhar|acirrar|assomar|desesperar|embravecer|encolerizar|enervar|enfurecer|enraivecer|exasperar
abetumado|calafetado
abetumar|argamassar|betumar|rebocar
abexim|abissínio|etíope
abismado|admirado|atónito|banzado|boquiaberto|espantado|estupefacto|maravilhado|pasmado|perplexo
abismal|abissal
abismar|banzar|espantar|pasmar|surpreender
abismo|abismo|abismo|abismo|abismo|abismo|abismo|abisso|caimento|escuridão|barranco|decadência|mistério|despenhadeiro|declínio|precipício|eversão|profundeza|queda|ruína
abjeção|aviltamento|baixeza|indignidade|infâmia|rebaixamento|vileza
abjectamente|degradantemente|ignobilmente|indignamente|torpemente|vilmente
abjeto|asqueroso|desprezível|ignóbil|imundo|nauseabundo|nojento|repelente|sórdido|sujo
abjugar|descativar|desemparedar|desencarcerar|excarcerar|libertar|soltar
abjuração|apostasia|deserção|retractação
ablação|amputação|corte|excisão|extirpação|mutilação
ablactação|desmame
ablactar|ableitar|desaleitar|desamamentar|desmamar
ablegar|banir|degradar|desterrar|exilar|expatriar
ablepsia|cegueira
ablução|banho|lavadura|lavagem
abluente|abstergente|detergente|detersivo
abnegação|abnegação|abnegação|altruísmo|desamor|desapego|desinteresse|indiferença
abnegado|abnegado|abnegado|altruísta|desinteressado|desprendido|filantropo
abnegar|abster|abster|renunciar
abóbada|arcada|arqueamento|cúpula|zimbório
abobado|amalucado|amalucado|apalermado|aparvalhado|apatetado|desatilado|tarouco
abóbora|jerimu|jerimum
abocanhado|mordido
abocanhar|abocanhar|abocanhar|caluniar|morder|desacreditar|deslustrar|desonrar|desprestigiar|difamar|ignominiar|infamar
abolachado|amachucado
abolachar|amachucar|amarrotar
aboletar|alojar|alojar|aquartelar
abolição|anulação|cessação|derrogação|extermínio|extinção|supressão
abolicionista|libertador
abolido|abortado|anulado|eliminado|extinto|suprimido
abolir|suprimir
abominação|aversão|execração|repulsão
abominado|detestado|execrado|odiado
abominar|detestar|execrar|odiar
abominável|abominoso|detestável|execrando|execrável|insuportável|nefando|odioso|ominoso
abonação|abonamento|abono|caução|fiança|garantia
abonador|fiador|responsável
abonançado|abrandecido|aliviado|amainado|aplacado|mitigado|suavizado
abonar|afiançar|afiançar
aborígene|autóctone|crioulo|indígena|nativo
aborrecer|agastar|enfadar|enfastiar|entediar|maçar
aborrecido|enfadado|enfastiado|entediado
aborrecimento|agastamento|enfado|maçada|tédio
aborto|monstro|monstruosidade
abraçado|adoptado
abraço|amplexo
abrandado|acalmado|pacificado|serenado
abrandamento|abrandecimento
abrandar|acalmar|adoçar|amenizar|suavizar
abrasado|abrasado|aceso|inflamado
abrasador|ardente|cálido|esbraseante|fogoso|incandescente|vulcânico
abrasão|curetagem|raspagem
abrasivo|desgastador|esmeril|pulidor
abreviação|abreviatura
abreviado|encurtado|reduzido|sintetizado|substanciado
abreviar|compendiar|condensar|encurtar|epilogar|recapitular|reduzir|resumir|sintetizar|sumariar
abreviativo|encurtador|resumidor|simplificador
abrigada|abrigo|asilo|cobertura|reduto|refúgio|resguardo|valhacouto
abrigado|amparado|confortado|consolado|protegido
abrigar|acoitar|homiziar
abrilhantar|brunir|polir|puir
abrir|abrir|furar|penetrar|perfurar|terebrar|transfixar
abrolhado|abrolhoso|espinhento|espinhoso
abrolho|espinho|estrepe
abroquelado|defendido|escudado|protegido
abrupto|alcantilado|clivoso|declivoso|escarpado|íngreme|ladeirento
abrutecido|embrutecido
abscindido|amputado|mutilado
abscindir|acutilar|cortar|fender|ferir|golpear|rasgar|vulnerar
absolto|absolvido|desculpado|perdoado
absolutismo|autocracia|despotismo|ditadura|tirania
absoluto|integral|inteiro
absolver|absolver|absolver|desculpar|remitir|perdoar
absolvição|absolvição|absolvição|absolvição|indulto|perdão|remissão
absorção|absorvência|aspiração|sucção
absorto|absorvido|introverso|introvertido
absorvente|esponjoso
absorver|aspirar|chupar|haurir|sorver|sugar
abstenção|continência
abster|abster|desviar|evitar|impedir|refrear|sustar
abstinência|dieta|jejum
abstracto|abstraido
abstrair|alhear|alienar
abstruso|incoerente
absurdo|absurdo|absurdo|contra-senso|contraditório|sem razão|paradoxal
abundância|abundância|exuberância|opulência|riqueza
abundante|abundante|abundante|abundoso|copioso|numeroso|profuso|rico|volumoso
abusar|desmandar|exagerar|exorbitar
abusivo|censurável|condenável|criticável|imperdoável|repreensível|reprovável
abuso|afronta|afronta|agravo|agravo|ataque|desfeita|doesto|injúria|insulto
acabado|completado|completo|concluído|feito|terminado
acabamento|aperfeiçoamento|aprimoramento|conclusão|remate|retoque
acabar|completar|concluir|finalizar|findar|perfazer|rematar|terminar|ultimar
acabrunhar|acabrunhar|acabrunhar|acamar|assoberbar|adoecer|humilhar|enfermar|vexar
acaçapado|coberto|encoberto|escondido|latente|obducto|oculto|sonegado|velado
academia|ateneu|liceu
académico|aluno|aprendiz|discípulo|educando|estudante|leccionando
açafate|cesto
acafelar|entaipar
acairelar|agaloar
acalentar|adormecer|aninar|embalar|ninar
acalorado|amornado|incendido
acalorar|aquecer|aquentar|esquentar
açambarcar|monopolizar
acamo|focinheira|mordaça
acanhado|acanhado|acanhado|apertado|envergonhado|estreito|tímido
acanhamento|embaraço|timidez
acarar|acarear
acariciado|acarinhado|afagado|amimado|mimado
acariciar|acarinhar|afagar|ameigar|amimar|mimar|mimosear
acarrear|acarretar|carrear|conduzir|transportar
acasalado|emparelhado|irmanado|jungido
acasalar|copular
acaso|casualidade|contingência|eventualidade|possibilidade
acastelhanar|espanholar|espanholizar
acatar|cumprir|obedecer
acautelado|precavido|prevenido|previdente|prudente
acautelar|precaver|prevenir|ressalvar
acção|acção|acção|acto|gesto|feito|obra
aceder|aquiescer
aceitação|aprovação|confirmação|corroboração|legalização|ratificação|roboração|validação
aceitar|admitir|admitir|concordar
aceitável|admissível|plausível|razoável|suportável|tolerável
acelerado|apressurado|depressa|rápido|veloz|vertiginoso
acelerar|açodar|aligeirar|apressar|correr|estugar
acenar|bracear|bracejar|gesticular
acender|atear|conflagrar|incendiar|inflamar
acendrado|acrisolado|purificado
aceno|gesto|meneamento|meneio
acentuar|frisar|salientar|sobressair|sublinhar
acepção|interpretação|sentido|significação
acepilhar|aplainar|desbastar
acepipe|guloseima|petisco|pitança|pitéu
acerado|mordaz|satírico
acerbo|acetoso|acre|agre|agro|amargo|amargoso|amaro|apimentado|avinagrado
acertado|acordado|ajustado|ajustado|ajustado|combinado|contratado|convencionado|estabelecido|estipulado
acertar|acertar|acertar|ajustar|assestar|ajustar|atingir|ajustar|concertar|convencionar
acervo|montão|pilha|ror
acessão|promoção
acessível|acessível|alcançável|atingível|conseguível
acesso|acesso|acesso|aproximação|entrada|chegada
acessório|inferior|secundário
acético|ácido|acrimonioso
achacado|achacado|achacado|achacoso|amuado|adoentado|chateado|combalido|maçado|doente|mal-humurado|enfermo
achacar|acriminar|acusar|chibar|criminar|culpar|delatar|denunciar|incriminar|inculpar
achado|achado|achado|descoberta|descoberto|inventiva|encontrado|invento
achamboar|achavascar
achanar|achanar|achanar|achanar|alisar|alisar|aplanar|desempolar|espaldar|puir
achaque|afecção|doença|enfermidade|mal|moléstia|morbo|padecimento
achar|descobrir|encontrar
achavascado|agreste|agreste|bronco|desabrido|inculto|rude|selvagem|tosco
achega|achego|adjutório|adminículo|ajuda|auxílio|demão|socorro
achegado|aconchegado|confortado
achegar|aconchegar|conchegar
achicanar|chicanar
achincalhamento|achincalhe
achincalhar|caçoar|empulhar|escarnecer|mofar|motejar|ridicularizar|ridicularizar|troçar|zombar
acicatar|açular|afervorar|avivar|espertar|espicaçar|estimular|excitar|incitar
acicate|chilena|espora
acidade|acidez|acrimónia|azedia|azedume
acidar|acidificar|acidular|azedar
acidentado|montanhoso
acidental|acidental|acidental|casual|casual|eventual|fortuito
acidificado|azedado
acima|supra
acinesia|imobilidade|paralesia
acinte|picardia|pirraça
acirrado|austero|implacável|incomplacente|inexorável|inflexível|inquebrantável|intransigente|supercilioso
acirrante|cativante|convidativo|estimulante|provocante|tentador
aclamação|saudação
aclamar|anunciar|proclamar
aclaração|aclaramento
aclarado|alumiado|iluminado
aclarar|elucidar|esclarecer|explanar|ilustrar
aclimar|aclimatar
aclive|declive|encosta|inclinação|ladeira|pendor|quebrada|rampa
acobardar|acovardar|amedrontar|apavorar|assombrar|assustar|atemorizar|aterrar|aterrorizar|espavorir
acochar|arrochar
açodado|apressado|precípite|veloz
açodamento|atrapalhação|azáfama|imprudência|precipitação|pressa
acoimar|acoimar|acoimar|acoimar|apenar|autuar|coimar|condenar|multar|penalizar
açoitar|azorragar|bater|vergastar|zurzir
açoite|azorrague|chicote|látego|pingalim|pinguelim|vergalho
acolá|além|ali|lá
acolhedor|hospitaleiro
acolher|acolher|acolher|acomodar|amparar|albergar|amparar|alojar|apoiar|alojar|asilar|hospedar
acolhido|asilado|protegido
acolhimento|guarida|protecção
acolitar|acudir|ajudar|auxiliar|coadjuvar|salvar|socorrer
acólito|adjutor|ajudante|assessor|assistente|auxiliador|auxiliante|coadjutor
acometer|acometer|acometer|assaltar|descompor|atacar|desfeitear|doestar|injuriar|insultar|invectivar|ofender|provocar
acometida|acometida|acometida|acometimento|agressão|arremetida|assalto|ataque|cometida|investida|ofensiva|opugnação
acometido|agredido|assaltado|atacado
acomodação|acomodação|acomodação|adaptação|arranjo|colocação|disposição|posição
acomodadiço|complacente|condescendente|dúctil|transigente
acomodado|pacato|plácido|quieto
acomodável|adaptável|adequável|ajustável|amoldável
acompanhado|escoltado
acompanhamento|comitiva|seguimento|séquito
acompanhar|acompanhar|acompanhar|escoltar|seguir
aconselhar|admoestar|alvitrar|inculcar|insinuar|instilar|insuflar|orientar|propor|recomendar
aconselhável|recomendável
acontecer|intercorrer|ocorrer|sobrevir|suceder
acontecido|ocorrido|realizado|sucedido
acontecimento|acontecimento|acontecimento|caso|evento|facto|ocorrência
açorado|ávido|insaciável|sôfrego
acorcovar|alcatruzar|alombar|arcar|arquear|corcovar|curvar|encurvar|encurvar|recurvar
acordão|aresto|sentença
acordar|acordar|acordar|ajustar|despertar|ajustar|ajustar|combinar|contratar|convencionar|estipular|pactuar
acordeão|concertina|harmónica|sanfona
acordo|acordo|acordo|combinação|conciliação|contrato|concordância|convenção|concórdia|convénio|conformidade|negócio|congraçamento|pacto|consonância|tratado|entendimento|harmonia
acoria|bulimia|insaciabilidade|orexia
acoroçoar|animar|encorajar|entusiasmar|estimular|incentivar|incitar|pungir
acorrentado|acorrentado|acorrentado|agrilhoado|amarrado|algemado|amarrado|encadeado|atado
acorrentar|agrilhoar|encadear
acossa|acossamento|persecução|perseguição
acossado|acuado|perseguido
acossar|acuar|caçar|perseguir
acostamento|assento|cadeira|encosto
acostar|apoiar|arrimar|assentar|colocar|depositar|pôr|postar
acostumado|afeito|avezado|habituado|viciado
acostumar|afazer|avezar|habituar
açougue|talho
açougueiro|carniceiro|magarefe
acracia|anarquia|anarquia
acreditado|autorizado
acreditar|confiar|crer
acrescentado|acrescido|alargado|ampliado|amplificado|aumentado|dilatado|estendido
acrescentamento|acrescento|acréscimo|ampliação|amplificação|aumento|extensão
acrescentar|acrescer|alongar|alongar|alongar|alongar|ampliar|amplificar|aumentar|avultar
acrídio|gafanhoto
acrisolamento|purgação|purificação
acrisolar|expurgar|limpar|mondar|purgar|purificar
acroma|acromia|descoloração|descora|descoramento
acrómico|descolorido|descorado|incolor
actividade|diligência|operosidade
actuação|comportamento|conduta|procedimento
actual|hodierno|moderno|novo|recente
actualmente|agora|presentemente
actuar|agir|operar
açucarar|adocicar
açude|comporta|dique|eclusa|represa
acudido|ajudado|auxiliado|socorrido
açulado|atiçado|instigado|provocado
açulador|estimulador|excitador|incitador|instigador
acuminado|pontiagudo
acumulação|aglomeração|concentração
acumulado|aglomerado|amontoado|reunido
acumular|aglomerar|aglomerar|amontoar|apinhar|reunir
acurado|amaricado|aperfeiçoado|caprichado
acusação|arguição|criminação|delação|denúncia|denunciação|querela
acusado|criminado|culpado|denunciado|indiciado|réu
acusador|arguidor|censor|recriminador
adágio|anexim|apotegma|ditado|dito|máxima|provérbio|rifão
adamado|afeminado|dengue|efeminado
adaptado|adequado|ajustado|ajustado|ajustado|apropriado
adaptar|adequar|ajustar|ajustar|ajustar|apropriar|conciliar|harmonizar
adega|frasqueira
adejar|aplainar|drapejar|esvoaçar|pairar|planar|revoar|revolutear|voar|voejar
adelgaçar|aflautar
ademais|demais
adepto|aderente|partidário|prosélito|sectário|sequaz
adereço|adorno|atavio|enfeite|ornamento
adernar|adornar|aformosear|alindar|aparatar|ataviar|decorar|embelezar|enfeitar|engalanar
adestrado|amestrado|doutrinado|educado|ensinado|explicado|formado|instruído|leccionado|pontificado
adestramento|amestração|domesticação
adestrar|amestrar|doutrinar|educar|ensinar|explicar|formar|instruir|leccionar|pontificar
adiado|delongado|diferido|posposto|prorrogado
adiamento|adiamento|adiamento|delonga|procrastinação|diferimento|protelação|dilação|protraimento|prorrogação|protelação|protraimento
adiantado|adiantado|adiantado|antecipado|avançado
adiantamento|antecipação|avanço
adiantar|antecipar
adiar|adiar|adiar|delongar|pospor|diferir|procrastinar|pospor|prolongar|procrastinar|protelar|prorrogar|protrair|protelar|retardar
adiável|prorrogável
adição|soma
adicional|suplementar
adicionar|aditar|juntar|somar
adimplemento|preenchimento
adinamia|adinamia|adinamia|anemia|debilidade|astenia|fraqueza
adinâmico|afadigado|alquebrado|alquebrado|cansado|derreado|esgotado|exausto|extenuado|fatigado
adipoma|lipoma
adiposidade|banha|gordura|obesidade
adiposo|adiposo|adiposo|gordo|gorduroso|obeso|graxo|oleoso|untuoso
adir|agrupar|ajuntar|coleccionar|coligir|grupar|juntar|reunir
aditamento|adscrição
adivinha|adivinhação|enigma
adivinhador|adivinho|bruxo|nigromante
adivinhar|conjecturar|imaginar|julgar|pressentir|pressupor|presumir|prognosticar|supor
adjacência|arredor|circunvizinhança
adjacente|chegado|confinante|convizinho|imediato|propínquo|próximo|vizinho
adjecção|junção|ligação|união
adjunto|adstrito|adstrito|ajuntado|anexo|anexo|apenso|coadunado|contíguo|junto
administração|gestão|governo
administrado|dirigido|governado
administrador|gestor
administrar|comandar|dirigir|gerir|governar|reger
admiração|assombro|espanto|pasmo|surpresa
admirador|apreciador|simpatizante
admirar|apreciar|contemplar
admirável|assombroso|espantoso|estupendo|excelente|excelso|formidável|inaudito|magnificente|magnífico
admissão|recepção
admitido|admitido|admitido|permitido|recebido|recepcionado
admitir|admitir|comportar|consentir|permitir
admoestação|admonenda|descompostura|ralhação|ralho|reprimenda
admoestante|repreendedor|repreensor
adoidado|aloucado
adoidar|amalucar|endoidecer
adolescência|juvenilidade|juventude|mocidade|puberdade
adolescente|jovem|juvenil
adopção|filiação
adoptar|escolher|usar
adoração|culto|homenagem|veneração
adorador|adorante|idólatra|venerador
adorar|amar|apaixonar|gostar
adormecedor|narcótico|soporífero
adormecido|entorpecido|letargo
adormecimento|entorpecimento|letargia
adormentar|desfalecer|entibiar|entorpecer
adornado|adornado|adornado|aformoseado|elegante|ajaezado|garrido|alindado|vistoso|arreado|embelezado|enfeitado|ornado|ornamentado
adquirir|comprar
adrede|expressamente
adro|átrio
adstringir|amarrar|anexar|anexar|atar|coadunar|enredar|juntar|ligar|prender
adstrito|adstrito|sujeito
aduana|alfândega
adubado|adubado|adubado|adubado|adubado|adubado|adubado|condimentado|condimentado|estrumado|temperado|temperado
adubar|adubar|adubar|condimentar|estercar|temperar|estrumar
adubo|adubo|adubo|condimento|esterco|especiaria|estrume|tempero|excremento
adulação|adulação|adulação|bajulação|lisonja
adulador|bajulador
adular|bajoujar|bajular|embandeirar|lisonjear
adulterador|contrafactor|falsificador
adustão|cauterização
aduzir|aduzir|aduzir|alegar|trazer|apresentar|exibir|expor|mostrar
ádvena|adventício|estrangeiro|exótico
advento|chegada|vinda
adversar|contradizer
adversário|competidor|contendedor|contendor|inimigo|justador|opoente|oponente|opositor|rival
adversidade|calamidade|catástrofe|desgraça|fatalidade|flagelo|infortúnio|revés|tragédia
adverso|contrário|desconforme|inverso|opoente|oposto
advertência|aviso|mensagem|recado
advertido|avisado|comunicado|informado|inteirado|intimidado|notificado
advertir|avisar|comunicar|informar|inteirar|intimar|notificar
advogado|jurisconsulto|jurisperito|jurista|legisperito|legista
advogar|defender
aeração|arejamento|arejo|ventilação
aéreo|aéreo|aéreo|airado|alheado|leviano|desatento|distraído
aerólito|meteorito
aeronauta|aviador
aeronáutica|aviação
aeronave|aeroplano|avião
aeróstato|balão|dirigível
afã|labor|labuta|lavor|lida|trabalho
afabilidade|amabilidade|atenção|cortesia|delicadeza|educação|gentileza|graciosidade|obséquio
afadigar|afadigar|afadigar|afadigar|cansar|esfalfar|estafar|estrompar|extenuar|fatigar
afago|carinho|lisonja|mimo
afagos|carinhos|mimos|paparicos
afamado|célebre|conhecido|famoso
afamar|celebrizar
afanoso|complicado|custoso|laborioso|operoso|trabalhoso
afastado|afastado|afastado|ausente|distante|retirado|longínquo|remoto|semoto
afastamento|encolhimento|isolamento|retiro|retraimento|solidão
afastar|afastar|alongar|alongar|alongar|alongar|distanciar
afável|aprazível|brando|doce|harmonioso|meigo|terno
afazeres|fainas|negócios|serviços|trabalhos
afear|desfear
afectação|amaneiramento|pedantismo|pretensão
afectado|aparente|fingido|simulado
afecto|amizade|amor|amor|apego|benevolência|fraternidade|simpatia|ternura
afectuoso|amorável|amoroso|carinhoso|querençoso
afeição|afeição|afeição|apreço|dedicação|consideração|estima|respeito
afeiçoar|apegar|simpatizar
aferir|medir
aferrado|ferrenho|tenaz
aferro|afinco
aferroar|aguilhoar|ferretoar|ferroar
aferventar|ferventar|ferver
afiado|aguçado|agudo|amolado
afiançar|afiançar|caucionar|garantir
afiar|aguçar|amolar|amolar|aparar|apontar
afim|análogo|conforme|congénere|idêntico|igual|semelhante
afinado|ajustado|ajustado|ajustado|justo|rectificado
afinal|enfim|finalmente|por fim
afinar|apurar
afincamento|birra|caturrice|cisma|obcecação|perrice|teima|teimosia|teimosice|turra
afirmação|asserção|asseveração|certeza
afirmar|declarar
afirmativo|asseverativo|positivo|sim
aflar|bafejar|soprar
aflição|agonia|angústia|aperto|apertura|martírio|tormento|tortura|tribulação
afligir|amofinar|angustiar|atormentar|torturar|tratear
aflitivo|angustiante|cruciante|doloroso|excruciante|lancinante|penoso|pungente|torturante
aflito|amargurado|angustiado|atormentado
afluência|concorrência
afofamento|amaciamento|amolecimento
afogueado|ardente|incendiado|queimado|torrado|tostado
afoiteza|arrojo|atrevimento|audácia|coragem|denodo|desembaraço|impavidez|intrepidez|ousadia
afoito|aguerrido|aguerrido|alentado|animoso|audacioso|audaz|corajoso|destemido|ousado
aforamento|emprazamento|enfiteuse
aforar|privilegiar
afortunado|fausto|feliz|próspero
afronta|afronta|cansaço|canseira|fadiga|fastio|quebreira|sufocação
afrontar|desafiar|provocar|reptar
afrontoso|infamante|injurioso|insultuoso
afrouxamento|atraso|retardamento
afrouxar|alargar|desapertar
afugentar|expulsar|repelir|varrer
afundamento|naufrágio|soçobro
afundar|naufragar|soçobrar
agachado|alapado|dobrado|encolhido|flectido|inflectido|vergado
agarrado|preso|seguro
agarrar|agarrar|agarrar|agarrar|agarrar|agarrar|agarrar|alcançar|amparar|catrafilar|alcançar|amparar|trancafiar|alcançar|cativar|trincafiar|apanhar|pegar|filar|prender|segurar
agastadiço|assomadiço|irascível
agastado|agastado|agastado|colérico|debilitado|encolerizado|depauperado|enraivecido|dessorado|fulo|enfraquecido|furibundo|extenuado|furioso|irritado
agatanhar|arranhar|esgatanhar|unhar
agência|dependência|escritório|filial|sucursal
agenciador|agente|negociador
agenciar|comerciar|negociar
agigantado|colossal|descomedido|descomunal|desmarcado|desmedido|desmesurado|enorme|excessivo|imenso
ágil|desembaraçado|destro|dextro|expediente|expedito|hábil|jeitoso|manipresto|prestímano
agilidade|desembaraço|destreza|facilidade|prontidão
ágio|juro|lucro|usura
agiota|onzeneiro|usurário
agitação|alvoroço|alvoroço|conflito|desordem|embrulhada|espalhafato|matinada|motim|perturbação
agitado|alvoroçado|ansioso|buliçoso|frenético|impaciente|inquieto|insofrido|malsofrido|nervoso
agitador|amotinador|revolucionário
aglomerar|aglomerar|apinhar
agoireiro|agoureiro|augure
agoirento|agourento
agoniado|anojado|enjoado|enojado|nauseado
agraciar|amnistiar|indultar
agraço|hortaliça|legume|verdura
agradar|aprazer|deleitar
agradável|aprazível|deleitável
agradecido|grato|reconhecido
agradecimento|congratulação|gratulação|reconhecimento
agrado|agrado|agrado|alacridade|aprazimento|alegria|prazimento|bom-humor|contentamento|desfastio|entusiasmo|jovialidade|jubilidade
agravar|aumentar|exacerbar
agravo|agravo|dano|detrimento|estrago|perda|prejuízo
agregação|associação|reunião
agregado|associado|confederado
agregar|associar|casar|reunir
agremiação|assembleia|associação|clube|corporação|grémio|junta|sociedade
agressivo|agressivo|agressivo|agressivo|hostil|invasivo|ofensivo|ofensivo
agressor|assaltante|atacador|atacante|invasor
agreste|agreste|áspero|bravio
agricultar|amanhar|arar|cultivar|hortar|lavrar|sulcar
agricultor|colono|cultivador|cultor|lavrador
agricultura|cultivação|cultura|lavoura|lavra|lavradio
agrupamento|ajuntamento
agrura|desconsolação|desgosto|mágoa|pesar|sofrimento
água|chuva
água-furtada|clarabóia|lucerna|trapeira
aguaceiro|bátega|chuvada|chuvarada
aguar|banhar|irrigar|regar
aguardar|esperar
aguardente|bagaceira|cachaça
agudeza|argúcia|artifício|astúcia|esperteza|finura|lábia|paleio|sagacidade|solércia
aguentar|manter|sustentar
aguerrido|aguerrido|armífero|armígero|beligerante|combatente|guerreiro|mavórcio|militar|soldado
aguilhão|espigão|espinho|ferrão|pua
aguilhoada|ferretoada|ferroada|lançaço|picada|pontada|pontoada
agulhada|alfinetada
aia|camareira|criada
aio|camareiro|criado|escudeiro|pajem
airosidade|donaire|elegância|esbelteza|garbo
airoso|belo|bonito|esbelto|formoso|galante|garboso|guapo|jeitoso|venusto
ajaezar|jaezar
ajeitar|alinhavar|alinhavar|alinhavar|alinhavar|amaneirar|preparar
ajuizado|conciliador|judicioso|moderado|ordeiro|sensato
ajuntador|coleccionador
ajustamento|ajuste
ala|ala|ala|fileira|flanco|renque|lado
alagadiço|brejoso|enlameado|miasmático|paludoso|pantanoso
alagado|inundado
alagamento|aluvião|dilúvio|enchente|inundação
alagar|inundar
alambique|destilador
alameda|parque
alanceado|ferido|golpeado
alancear|lancear|mortificar
alantíase|botulismo|envenenamento
alarde|inanidade|jactância|orgulho|ostentação|soberbia|ufania|vaidade|vanglória
alardear|bazofiar
alargamento|dilatação|expansão
alarido|algazarra|balbúrdia|banzé|berreiro|celeuma|chinfrim|gritaria|matinada|tropel
alarmado|aterrado|desassossegado|inquieto|sobressaltado
alarmar|alvoroçar|alvorotar|desassossegar|sobressaltar
alarme|rebate
alarvado|alarvo
alastrar|difundir|espalhar|grassar|lavrar|propagar|transfundir
albergaria|albergue|estalagem|hospedagem|hospedaria|pousada
alçada|competência|jurisdição
alcaiote|alcoviteiro
alcançado|alcançado|alcançado|apanhado|conseguido|obtido
alcançar|alcançar|alcançar|alcançar|alcançar|compreender|conseguir|depreender|obter|entender|inferir|perceber|saber
alcanfor|alcânfora|cânfora
alcantil|pináculo|píncaro
alçar|edificar|erigir
alcatifa|tapeçaria|tapete
alcatifar|alfombrar
alcatrão|breu|pez|piche
alcatruz|frasco|jarra|jarro|vaso
alcoice|alcouce|bordel|lupanar|prostíbulo
alcoólatra|alcoólico
alcunha|cognome|epíteto
alcunhar|apelidar|cognominar|denominar|intitular
aldeão|camponês|campónio|maloio|rurícola|vilão
aldeia|localidade|lugarejo|povoação|povoado
aldraba|cadeado|ferrolho|loquete|tranqueta|trinco
alegação|alegação|alegação|alegado|argumento
alegoria|parábola
alegórico|emblemático|simbólico|umbrátil
alegrar|contentar|regozijar
alegre|contente|feliz|jubiloso|prazenteiro|satisfeito
aleijado|coxo|manco|manquitó|manquitola|rengo
aleitamento|amamentação|lactação
aleitar|amamentar|lactar
aleivosia|deslealdade|falsidade|farsa|fingimento|hipocrisia|impostura|perfídia|traição|tredice
aleivoso|desleal|falso|farsante|hipócrita|inconfidente|infiel|pérfido|proditório|púnico
além disso|aliás|ou por outra|outrossim
alemão|boche|germânico|teuto|teutónico
alentar|confortar|consolar|reconfortar
alento|ânimo|fôlego
alfa|começo|encetativo|estreia|inauguração|início|princípio
alfange|catana|cimitarra|cutelo|sabre|terçado
alfarrábio|calhamaço|cartapácio|livro
alfarrabista|ferro-velho
alfinetar|satirizar
alfombra|relvado
alforria|emancipação|libertação
alforriar|manumitir|resgatar
alfurja|esterqueira|lixeira|monturo
algar|antro|catacumba|caverna|cavidade|cova|covil|fossa|furna|gruta
algarismo|número
algema|grilhão|grilheta
algemar|maniatar|manietar
algibeira|bolso
algo|alguma coisa|um pouco|um tanto
algoz|carrasco|verdugo
algum|qualquer
algures|em algum lugar|em alguma parte
alheação|alheamento|desatenção|distracção|esquecimento
aliado|coligado
aliança|associação|coligação|confederação|federação
aliar|coligar|confederar
alicerçar|assentar|cimentar|consolidar|estabilizar|firmar|fixar|fundar
alicerce|firmamento|sustentáculo
aliciação|aliciamento
aliciador|aliciante|engajado|subornador
aliciar|atrair|cativar|convencer|incutir|induzir|instigar|persuadir|seduzir
alienação|alienação|alienação|alucinação|doidice|delírio|loucura|demência|desatino|desvairo|desvario|insânia|loucura
alienado|demente|desatinado|doido|insano|insensato|louco|maluco
alienígena|estrangeiro|estranho|forasteiro
alienista|psiquiatra
alígero|breve|célere|fugaz|ligeiro|precípite|presto
alimentação|alimento|alimento|sustento
alimentado|alimentado|alimentado|manteúdo|nutrido|mantido|sustentado
alimentar|alimentar|alimentar|cevar|fomentar|nutrir
alimentício|alimentício|alimentício|alimentoso|nutritivo|esculento|substancial|nutritivo
alimento|alimento|comida|iguaria|maná|manjar
alimentos|mantimentos|provisões|vitualhas|víveres
alimpadura|varredura
alinhado|desempenado
alinhavar|alinhavar|alinhavar|alinhavar|alinhavar|alinhavar|alinhavar|alinhavar|alinhavar|alinhavar|apontoar|cerzir|delinear|coser|costurar
alinho|amanho|amanho|amanho
alisar|alisar|complanar|igualar|nivelar|rasar|rasourar
alistado|arrolado|registado
alistamento|arrolamento|catálogo|inventário|lista|relação|rol
alistar|arrolar|enumerar|inventariar|inventariar|relacionar
aliviar|atenuar|desapoquentar|mitigar|pacificar|serenar|sossegar|tranquilizar
alívio|conforto|consolação|refrigério
alma|espírito|psique
almagra|almagre
almalha|bezerra|novilha|vitela
almanaque|anuário|calendário|efeméride|folhinha
almofariz|gral|pilão
alocução|saudação
aloé|babosa
alojado|aninhado|hospedado|instalado
alongado|distendido|esticado|estirado|prolongado
alongamento|distensão|estiramento
alongar|alongar|alongar|alongar|alongar|alongar|alongar|atrasar|distender|delongar|encompridar|demorar|esticar|deter|estirar|retardar|temporizar
alopecia|calvície
alourado|flavo|fulvo|louro
alpendre|telheiro
alta|subida
alteia|malvaísco
alteração|alteração|alteração|alteração|diferença|modificação|mudança
alterado|alterado|alterado|alterado|alterado|alterado|alterado|alterado|alterado|alterado|confuso|demudado|modificado|desarranjado|desfigurado|mudado|perturbado|desfigurado|substituído|transtornado|diferente|trocado|túrbido|mudado|transformado
alterar|modificar|mudar
altercação|contenda|controvérsia|debate|discussão|litígio|polémica
altercador|resmungão|rezingueiro
altercar|contestar|controverter|discutir
alternação|revezamento
alternado|intermitente|revezado|salteado
alternar|intercalar|interpolar|intervalar
alternativa|escolha|opção|selecção
alternativo|mútuo|recíproco
alteza|princesa|príncipe
altivez|altivez|altivez|arrogância|dobrancearia|empáfia|sobrançaria|presunção
altivo|amaneirado|arrogante|entufado|fátuo|imodesto|jactancioso|orgulhoso|pedante|presumido
alto|alto|alto|alto|alto|alto|alto|basta|cima|elevado|tá|cimalha|eminente|cimeira|sobranceiro|cimo|superior|cocuruto|supino|cume|cumeeira
altura|fundura|profundeza|profundidade
aluado|amalucado|amalucado|lunático|maníaco|telhudo
alucinado|desvairado|exaltado|excitado|tresloucado
alucinamento|desvairamento
alucinar|desvairar|enlouquecer|exaltar|tresloucar
alude|avalancha|avalanche
aludido|citado|mencionado|referido
aludir|mencionar
aluguer|arrendamento|locação
aluimento|derrocada|desabamento|desmoronamento
alumiação|iluminação
alumiar|iluminar
alusão|menção|referência
alusivo|referente
alva|alvor|alvorada|antemanhã|aurora|dilúculo|madrugada
alvacento|cinzento|gris|pardacento|pardo
alvejar|alvorecer|alvorecer|branquear|branquejar|clarear|clarear|embranquecer|encanecer
álveo|leito
alvéolo|casulo
alvião|enxadão|picão|picareta
alvino|intestinal
alvitre|proposta
alvo|alvo|alvo|alvo|alvo|alvo|alvo|branco|escopo|fim|cândido|mira|intuito|claro|meta|níveo|objectivo
alvorecer|alvorecer|amanhecer|raiar
alvura|brancura|candura
ama|ama|ama|governanta|nutriz|patroa
amaciar|amolentar
amada|dulcinéia|namorada|querida
amado|estremecido|querido
amador|amador|amador|amante|diletante|amásio|namorado
amadurar|amadurecer|assazonar|madurar|sazonar
amadurecido|maduro|sazonado
amadurecimento|maduração|sazão
âmago|íntimo|intrínseco|profundo
amaldiçoado|maldito|precito
amaldiçoar|amaldiçoar|amaldiçoar|imprecar|maliciar|pragar|praguejar
amaleitado|maleitoso
amálgama|fusão|liga
amanhado|arado|cultivado|lavrado
amanho|amanho|amanho|amanho|amanho|cultivo|preparação|preparo
amansado|desbravado|domado|domesticado|dominado|manso
amansar|desbravar|docilizar|domar|domesticar|dominar
amargor|amargura
amarra|cabo|corda|talinga
amarrado|amarrado|atado
amarrilho|atilho|cordão|cordel|fio
amarrotado|enxovalhado
amartelar|martelar
amásia|barregã|concubina
amável|atencioso|atento|cortês|deferente|dócil|gentil|obsequioso|respeituoso
ambição|anelo|anseio|avidez|cobiça|desejo|sede|sofreguidão
ambicionado|apetecido|cobiçado|desejado
ambicionar|anelar|ansiar|apetecer|aspirar|cobiçar|desejar|querer
ambicioso|ávido|cobiçoso
ambidestro|ambidextro
ambiente|envolvente
ambiguidade|anfibologia
ambíguo|dúbio|duvidoso
âmbito|contexto|contextura
ameaça|ameaço|prenúncio
ameaçador|ameaçador|ameaçador|cominador|minaz|minaz
amealhar|economizar
amedrontado|apavorado|assombrado|assustado|atemorizado|aterrorizado|espavorido|intimidado|pávido
amendoim|mendubi
amenidade|brandura|doçura|fleuma|mansidão|mansuetude|placabilidade|quietude|serenidade|suavidade
ameno|brando|comedido|delicado|pacífico|sereno|sossegado|suave
amianto|asbesto
amido|fécula
amigo|camarada|colega|companheiro
amiudado|assíduo|frequente
amnésico|desmemoriado
amo|senhor|senhoril
amoedado|cunhado
amofinação|aperreação|apoquentacão
amofinado|apoquentado|apreensivo|arreliado|preocupado|ralado|receoso
amolação|amoladura
amolar|amolar|resmonear|resmungar|rezingar|rosnar
amoldado|moldado
amoldar|amoldar|amoldar|amoldar|modelar|moldar
amolecer|molificar
amolecido|molificado
amolgadela|amolgadura|amolgamento
amor|amor|paixão
amorfo|disforme|horrendo|horrendo|hórrido|informe|monstruoso
amortecido|deprimido|desalentado|desanimado|descorçoado|esmorecido|prostrado
amostra|exemplar|modelo
amotinado|insurgente|insurrecto|revel|revoltoso|sedicioso
amotinar|insurgir|opor|rebelar|revoltar
amovível|deslocável|destacável|removível|transferível
amparo|apoio|arrimo|esteio|sustento
ampliador|aumentador|dilatador
amplidão|amplitude|extensão|grandeza|grandiosidade|vastidão
amplo|espaçoso|extenso|grande|largo|vasto
ampola|bolha|borbulha|empola
amputar|decepar|estropiar|mutilar
amuleto|talismã
amuo|arrufo
anacoreta|cenobita
anafado|luzidio|nédio
analepsia|convalescença
analfabeto|ignorante|iletrado
analisar|averiguar|estudar|examinar|explorar|indagar|investigar
análise|estudo
analista|comentador|crítico|exegeta
analizável|avalizável
analogia|conformidade|semelhança
anamnese|memória|recordação|relembrança|rememoração|reminiscência
anão|homúnculo|liliputiano|pigmeu
anarquia|anarquia|atrapalhação|barafunda|confusão|desordem|desorganização
anarquista|libertário
anátema|excomunhão|reprovação
ancas|ilhargas|quadris
ancestral|ancião|antepassado|antigo|ascendente|avito|avoengo
ancianidade|antiguidade
ancilostomíase|helmintíase|verminose
ancorado|aportado|fundeado
ancoradouro|fundeadouro|surgidouro
andaço|contágio|epidemia|praga
andadeiro|andador|andarilho|andejo|caminhante|caminheiro|viandante
andado|percorrido|trilhado
andamento|curso
andante|erradio|errante|nómada|nómade|prófugo|vagabundo|vagamundo|vagante
andar|andejar|caminhar|marchar
andrajo|farrapo|trapo
andrajoso|esfarrapado|esfrangalhado|maltrapido|maltrapilho
andrógino|androginóide|hermafrodita
anel|argola|aro
anelado|encaracolado
anelante|arfante|ofegante
anélito|bafo|fôlego|folgo|respiração|sopro
anestesiador|anestesista
anexar|anexar|apender|apensar
anexo|anexo|dentro|incluído|incluso|incorporado
angariar|recrutar
anglicano|britânico|inglês
anglicismo|inglesismo
angra|baía|calheta|enseada
animado|entusiasmado
animal|bicho
aniquilar|destruir|exterminar|extinguir
anite|proctite
aniversário|natalício
anjo|criancinha|querubim
anódino|calmante|sedante|sedativo
anorexia|fastio|inapetência
anormal|irregular
anotação|apontamento|lembrete
anotador|comentador
anotar|apontar|assentar|consignar|inscrever|registrar
anseio|ânsia|ansiedade|desespero|estertor|sofreguidão|vasca
ansiedade|impaciência|sofreguidão
antagonista|contraditor|opositor
ante|diante de|na presença de|perante
antecedente|precedente
anteceder|preceder
antecessor|predecessor
antecipadamente|antemão|previamente
antelmíntico|anti-helmíntico|vermicida|vermífugo
anteparo|atenção|cautela|circunspecção|cuidado|ponderação|precaução|prudência|tento
antepassados|ascendentes|avós|maiores
antepor|preferir
anti-helmíntico|vermicida|vermífugo
anti-sepsia|desinfecção
anti-social|associal
anticéptico|desinfectante
antídoto|contraveneno
antigo|idoso|macróbio|velho|vetusto
antilógico|ilógico|irracional
antipatia|aversão|ódio|repugnância|repulsa
antiquado|arcaico|obsoleto|retrógrado
antiquário|arqueólogo
antiquíssimo|milenário|remotíssimo
antologia|crestomatia|florilégio|selecta
antropófago|canibal
anuência|aquiescência|assentimento|autorização|concordância|consentimento|permissão
anuir|assentir|autorizar|consentir|outorgar
anunciador|proclamador
anúncio|pregão|proclamação
anuviado|anuviado
anuviar|nublar
anverso|obverso
apadrinhador|protector
apadrinhar|apadroar|apaniguar|proteger
apagado|desvanecido|extinto|sumido
apagar|extinguir
apaixonado|enamorado
apaixonar|enamorar|gostar
apalermar|aparvalhar|apatetar|atarantar
apalpar|palpar|tacteado|tactear
apanha|colheita
apanhar|colher|recolher
apaniguado|beneficiado|favorecido
aparato|esplendor|luxo|magnificência|ostentação|pompa|sumptuosidade
aparatoso|lauto|opíparo
aparecer|brotar|chegar|desabrochar|comparecer|eclodir|manar|nascer|romper|surgir
aparecimento|emergência|surgimento
aparelhamento|aparelho
aparelhar|irmanar
aparência|ar|aspecto|figura|fisionomia|semblante
aparentar|fingir|simular
apartado|desviado|separado
apartar|cortar|desconjuntar|desunir|disjungir|dividir|esconjuntar|repartir|separar
apascentar|pascer|pastar|pastorear
apatia|frieza|modorra|impassibilidade|sonolência|indiferença|inércia|insensibilidade
apático|indolente|modorrento|sonolento
apaziguar|aquietar|dissipar|sossegar
apear|descavalgar|desmontar
apedrejar|facetar|lapidar
apelação|recurso
apelar|recorrer
apelidado|chamado|denominado
apelido|sobrenome
apenas|exclusivamente|somente|unicamente
aperfeiçoar|aprimorar|melhorar|apurar|elevar|requintar|sublimar
aperitivo|aperitivo
apertão|atracão|atracão|empurrão|empuxão|encontrão|esbarro|puxão|repelão|repuxão
apertar|apoucar|estreitar|restringir
apetecível|apetente|desejável
apetite|gosto
apetitoso|deleitoso|delicioso|gostoso|saboroso
apetrechar|armar|equipar|municiar|petrechar
apetrecho|apresto
ápice|vértice
apiedado|compadecido|compassivo|condoído|exorável|sentimental
apiedar|condoer|enternecer
apito|assobio|sibilo|silvo
aplanado|nivelado
aplauso|ovação
aplicação|emprego
aplicar|empregar|impor|utilizar|infligir
apodrecido|corrupto|estragado
apodrecimento|decomposição|putrefacção
apogeu|auge|culminância
apoiado|bem|bravo
apoiar|concordar|estribar
apoio|base|escora|espeque|esteio|pedestal|suporte
apólogo|fábula|ficção
apontado|assinalado|indicado|indigitado
apontar|indicar|mostrar
apoquentação|desassossego|desinquietação|inquietação|nervosismo|ralação
apoquentar|apoquentar|desnortear|perturbar|transtornar
após|depois|em seguida|posteriormente
aposentado|emérito|jubilado|reformado
aposentar|reformar
aposento|quarto|sala
aposição|justaposição
apóstolo|evangelista|evangelizador|propagador
apostrofado|interpelado|repreendido
apoteose|deificação|divinização|endeusamento
apraz|aprazedor|aprazente
apreciação|avaliação|crítica|opinião
apreciado|considerado|estimado|respeitado
apreciar|considerar|reputar|respeitar
apreensão|consumição|inquietação|mortificação
apregoar|predicar|pregar
aprendiz|inexperiente|novato|novel|noviço
aprendizado|aprendizagem|estágio|tirocínio
apressadamente|rapidamente|velozmente
apressar|azafamar|precipitar
aprestar|aprontar
aprimorado|bem-educado|civilizado|correcto|cortês|esmerado|polido|rebuscado|requintado
aprisionado|cativo|detido|encarcerado|enclausurado|prisioneiro
aprisionar|encarcerar|enclausurar
apropriado|favorável|oportuno|propício|tempestivo
aprovado|autenticado|confirmado|legalizado|ratificado|reconhecido|revalidado|sancionado|validado
aprovar|assinar|autenticar|concordar|confirmar|subscrever|legalizar|ratificar|revalidar|sancionar|validar
aprumar|endireitar|perfilar
aptidão|capacidade|habilidade|inclinação|jeito|orientação|predisposição|propensão|qualidade|tendência
apto|capaz
apupar|vaiar
apurado|delicado|escolhido|perfeito
apuro|esmero|perfeição|primor|sublimidade
aquentado|esquentado
aqui|cá
aqui está|eis|vede
aquinhoar|compartilhar|compartir|partilhar|quinhoar
aquisição|compra|obtenção
árabe|arábico|mouro|sarraceno
aragem|bafejo|brisa|frescor|frescura
aranzel|lengalenga
arável|cultivável
arbitramento|brocardo|decisão|deliberação|despacho|determinação|julgamento|sentença
arbitrário|facultativo
arbítrio|talante|vontade
árbitro|avaliador|louvado|perito
arca|boceta|caixa|cofre
arcaboiço|arcabouço|armação|carcaça|esqueleto|estrutura
arcabouço|busto|tórax
arcado|arciforme|arqueado|corcovado|curvado|curvo|encurvado
arcebispo|clérigo|padre|pároco|prior|vigário
archote|brandão|facho|fogaréu|tocha
arco|círculo|roda
arder|chamejar|deflagrar|flagrar|flamejar
ardil|astúcia|manha|subtileza|tropelia
ardiloso|arteiro|doloso|astucioso|embusteiro|astuto|enganador|buliçoso|falaz|espertalhão|impostor|esperto|mentiroso|manhoso|obreptício|pícaro|patranheiro|sagaz|sub-reptício
ardor|calor
árduo|difícil
área|dimensão|espaço|extensão|superfície
areal|areão|areeiro
areento|arenoso|arisco|sabuloso
arejado|aventado|ventilado
arejar|ventanear|ventilar
arena|estádio|redondel
arengador|arengueiro
arfar|arquejar|esbaforir|ofegar
argentário|milionário|rico
argênteo|argentino|patagão|patagónio
argentino|prateado
argila|barro|greda
argumentar|discutir|esgrimir
aridez|secura|sequidão
árido|estéril|seco
arisco|espantadiço|esquivo|gravisco
aristocracia|fidalguia
armadilha|cilada|emboscada|embuste|insídia
armazém|arrecadação
armistício|trégua
aroma|cheiro|fragrância|odor|olência|olor|perfume
aromático|balsâmico|cheiroso|fragrante|odorante|odorífero|olorante|olorente|oloroso|perfumado
aromatizar|balsamar|balsamizar|perfumar
arquivo|registo|registro
arraçoar|racionar|raçoar
arraigado|enraizado
arraigar|enraizar|enraizar
arrancada|arranque
arranhadura|arranhão|escoriação|esfoladura|raspão
arranhar|escorchar|escoriar
arranjado|consertado|disposto|emendado|organizado|refeito|preparado|remendado|reparado|restaurado
arranjar|arrumar|consertar|colocar|emendar|dispor|refazer|organizar|remendar|preparar|reparar|restaurar
arranjo|conluio|conserto|conspiração|emendo|igrejinha|remendo|intentona|reparo|maquinação|restauro|panelinha
arrasado|assolado|devastado|talado
arrasar|arruinar|assolar|destruir|devastar|talar
arrastar|compelir|impelir
arrebatado|imprudente|impulsivo|insipiente|precipitado|precipitoso|temerário
arrebatamento|ímpeto|impulso
arrebatar|raptar|roubar
arrebentado|arruinado|falido
arrebentar|arruinar|estoirar|falir|estourar|explodir|rebentar
arrebol|rosicler
arrecadar|receber|recepcionar|receptar|recolher
arredor|beirada|proximidade
arredores|periferia
arrefecer|esfriar|resfriar
arrefecido|esfriado|resfriado
arrefecimento|esfriamento|resfriamento
arreliar|infernar|infernizar
arremessar|arrojar|atirar|disparar|impelir|impulsionar|lançar|propelir
arremesso|lançadura
arrepelar|puxar
arrependido|compungido|contrito|pesaroso
arrependimento|compunção|contrição|remorso
arrepiado|eriçado
arrepiar|eriçar|ouriçar
arrepio|calafrio|calefrio|horripilação
arrestar|confiscar|embargar
arresto|penhora
arrevesado|enredado|intrincado
arriscado|aventuroso|perigoso
arriscar|aventurar|malparar
arrolador|estatístico|recenseador
arrolar|recensear
arrombamento|rombo|rombudo
arrostar|defrontar|encarar|enfrentar
arrotar|eructar
arroteado|desbravado
arrotear|desbravar
arroto|eructação
arroubamento|embevecimento|enlevamento
arroubo|enlevo|êxtase
arroxeado|violáceo|violeta
arruaceiro|desordeiro
arruivado|ruivo
arrumação|maneira|método|ordem|processo|sistema
arrumado|danificado|deteriorado|estragado|viciado
artefacto|fabrico|manufactura|produção
artelho|maléolo|tornozelo
articulação|fala|pronunciação
articular|declamar|ler|proferir|pronunciar|recitar
artífice|opífice
artificial|sintético
artigo|cláusula|item
artilheiro|bombeiro
ascendência|progénie|prosápia
ascender|crescer|elevar|subir|trepar
ascensão|subida
ascetério|cenóbio
ascético|contemplativo|devoto
asco|enojo|nojo
ascoroso|ascoso
asfixiar|estrangular|sufocar
asneira|asnice|baboseira|dislate|disparate|necedade|pedantice|sandice|toleima|tolice
aspargo|espargo
aspecto|paisagem|vista
aspereza|austeridade|dureza|rispidez|rudeza|severidade
aspergido|borrifado
aspergimento|aspersão|espargimento
aspergir|borrifar|irrorar
áspero|duro|escabroso|forte|resistente|rijo
asqueroso|hediondo|horroroso|imundo|repugnante|sórdido
assacar|atribuir|imputar|infligir|irrogar
assaltante|bandido|bandoleiro|salteador
assanhado|desaforado|desbragado
assanhar|atiçar|encarniçar
assassinar|chacinar|fuzilar|massacrar|matar|trucidar
assassinato|assassínio|homicídio
assassino|celerado|criminoso|delinquente|facínora|homicida|malfeitor|matador|sicário
asseado|lavado|limpo|terso
assear|enxugar|lavar|limpar
assediado|sitiado
assediador|assediante|sitiante
assegurar|asseverar|certificar|confirmar|testificar
asseio|higiene|limpeza
assembleia|câmara|plenário|parlamento|reunião|tertúlia
assentado|assente
assentar|aterrar|botar|pousar
assestar|disparar
assexo|assexuado|assexual
assim que|logo que|mal
assimétrico|desarmónico|desigual|dissonante|irregular
assistido|observado|presenciado|testemunhado|visto
assistir|observar|presenciar|testemunhar|ver
assobiar|sibilar|silvar
assolapar|cavar|escavar|minar|solapar
assombramento|ensombramento|sombreamento
assunto|matéria|objecto|ponto|tema|tópico
assustador|terrificante|terrífico|terrível|tremendo
astro|planeta
astrologia|astromância
atabalhoado|trapalhão
atacar|brigar|combater|estrebuchar|guerrear|hostilizar|lutar|testilhar
atado|enleado|ligado
atadura|liame|ligadura
atalhar|atravancar|dificultar|embaraçar|entravar|estorvar|impedir|obstar|prejudicar|sustar
atalho|caminho|estrada|senda|tramite|trilho|vereda|via|viela
atapetar|entapetar|tapizar
atascadeiro|atoleiro|brejo|charco|lamaçal|lamaceira|lameiro|lodaçal|marnel|pantanal
atascar|atolar|chafurdar|enchafurdar
ataúde|caixão|esquife|féretro
atentar|constatar|notar|reparar
atento|atilado|cauteloso|circunspecto|discreto|prudente|sengo|sisudo|vigilante
atenuação|decrescimento|diminuição|enfraquecimento|redução
atenuado|minorado
atenuar|minorar|minuir
aterrador|medonho|pavoroso|tenebroso|tétrico
ateu|ímpio
atilar|esmerar
atinente|concernente|relativo|tocante
atleta|desportista
atoarda|balela|balela|boato|boato|rumor
átomo|corpúsculo
atordoado|aturdido|azoado|estonteado|zonzo
atordoamento|aturdimento|tontura|vertigem
atordoar|aturdir|azoar|entontecer|estontear|zabumbar
atormentado|importunado|obsesso|perseguido
atracção|encantamento|fascinação|fascínio|sedução
atraente|encantador|interessante|sedutor|simpático
atraiçoar|enganar|equivocar|iludir|ludibriar|trair
atrás|detrás
atrasado|moroso|procrastinado|retardado
atraso|delonga|delongado|demora|demorado|detença|detido|tardada|tardança
atravanco|embaraço|empecilho|empeço|encalhe|estorvo|impedimento|óbice|obstáculo|pespego
atravessar|cruzar|encruzar|galgar|passar|terçar|transpor
atrição|corrosão|desgaste
atroador|atroante|ensurdecedor|troante|tronante
atroar|ecoar|estrugir|restrugir|retumbar
atrocidade|barbaridade|crueldade|improbidade|maldade|malignidade|perversidade|perversidade|truculência
atrofiar|definhar|enfezar
atroz|bárbaro|bravio|brutal|bruto|cruel|feroz|ríspido|selvagem|severo
atufado|engolfado|mergulhado
augurado|conjecturado|prenunciado|previsto|prognosticado
augurar|auspiciar|fadar|predizer|pressagiar|pressentir|profetizar|prognosticar|vaticinar|visionar
augúrio|horoscópio|horóscopo|prenúncio|presságio|previsão|profecia|prognóstico|vaticínio
aula|lição
auréola|halo|resplendor
aurífero|aurígero
aurífice|ourives
auriflama|balsão|bandeira|estandarte|guião|pendão|signa
auscultar|escutar|ouvir
ausência|carência|escassez|exiguidade|falta|pouquidade|privação
austral|meridional|sul
autarquia|autonomia
autêntico|fidedigno|genuíno|real|verdadeiro|verídico
automaticamente|involuntariamente|maquinalmente
autómato|boneco|fantoche|marionete|títere
automóvel|carro|veículo|viatura
autónomo|independente
autópsia|necropsia
autor|responsável
autoridade|domínio|mando|poder
autoritário|dominador
auxiliar|facilitar
avacalhado|desmoralizado
avaliado|estimado|medido
avaliar|calcular|determinar|estimar|julgar
avançar|continuar|proceder|progredir|prosseguir|seguir
avanço|progressão|progresso
avantesma|avejão|espectro|fantasma
avarento|avaro|mesquinho|somítico|tacanho
avareza|mesquinhez|sovinice
avaria|desarranjo
aventura|façanha|proeza
averiguação|devassa|indagação|inquirição|investigação|perquirição|perquisição|pesquisa
avermelhar|carminar|corar|enrubescer|purpurear|ruborizar|vermelhar
aviar|despachar|expedir
avigorar|fortalecer|fortificar|revigorar|roborar|robustecer|tonificar
aviltante|desonroso|humilhante
aviltar|depreciar|desdenhar|desprezar|humilhar|menoscabar|rebaixar
avindo|congraçado|harmonizado
avistado|divisado|enxergado
avistar|divisar|enxergar
avolumado|empolado
avulsão|evulsão|extracção
axila|sovaco
axioma|máxima|postulado
azagaia|zagaia
azar|contratempo|má sorte
azebre|azinhavre|verdete
azeitar|lubrificar|olear|ungir|untar
azeite|óleo
azeitona|oliva
azotato|nitrato
azoto|nitrogênio
azotoso|nitroso
azucrinante|incomodativo|irritante
babadouro|babeiro
bacamarte|espingarda
bacanal|orgia
bacilo|bactéria|micróbio|microrganismo
bacio|bispote|penico|urinol
baço|embaciado|escurecido|opaco|toldado|turvo
bácoro|leitão
bafejo|hálito
bafiento|mofento
bafio|mofo|ranço
bagatela|futilidade|insignificância|ninharia
bago|granito|grânulo|grão
bailadeira|bailarina|dançadeira|dançarina
bailador|bailarim|bailarino|dançarino
baile|dança
bairrista|localista|regionalista
baiuca|bodega|locanda|taberna|tasca|taverna|tenda
baixar|decrescer|diminuir|encolher|minguar|subtrair
baixo|grave|inferior|insignificante|ordinário|plebeu|reles
bajoujo|lamecha
bajulador|subserviente
bala|projéctil
balaço|balázio|tiro
balançar|nutar|oscilar
balbo|gago|tartamudo|tátaro
balda|defeito|deformidade|imperfeição|pecha
baldado|desnecessário|dispensável|escusado|inútil|prescindível|supérfluo
baldar|falhar|fracassar|frustrar|gorar|malograr
baldeação|transbordo
baldear|transvasar|trasfegar
baliza|fronteira|limite|marca|marco
balsa|jangada
banal|comum|corriqueiro|ordinário|trivial|vulgar
banalidade|frivolidade|futilidade|trivialidade|vulgaridade
banca|carteira|mesa|secretária
banda|filarmónica|margem|orquestra
bando|grupo|quadrilha
bandulho|rúmen
banguela|desdentado
banido|precito|renegado|repudiado
banimento|degredo|deportação|desterro|exílio|expatriação|proscrição
banquete|boda|festim
baraço|barbante|cordel|guita
baralhar|confundir|desorientar|despistar|enlear|misturar
báratro|inferno
barbaridade|brutalidade|desumanidade
barbeiro|fígaro
barco|embarcação|navio|paquete
bardo|poeta|trovador
barita|óxido
barregã|manceba
barreiro|barroca
barrete|capuz|carapuça|casquete|gorro
barrica|barril|pipa|tonel
barricar|entrincheirar
barriga|bojo|ventre
barulho|estrondo|fragor
basco|biscainho|cantábrico|vasconço
baseado|fundamentado
basear|consistir|fundar
básico|capital|essencial|fundamental|imprescindível|indispensável|obrigatório|substancial|vital
bastão|bordão|cajado|chibata|haste|mastro|pau|vara|viga
bastar|chegar|satisfazer
bastardia|ilegitimidade
bastardo|degenerado|espúrio|ilegítimo
bastonete|varinha
bata|roupão
batalha|guerra
batalhador|combatente|gladiador|lidador|lutador|pelejador|pugnador
batedor|dianteiro|precursor
batel|bote|canoa|escaler
bater|desancar|escadeirar|espancar|fustigar|maltratar|percutir|sovar
batido|derrotado|suplantado|vencido
batoteiro|trapaceiro
bazar|estabelecimento|loja
bazófia|fanfarrice|fanfarronice|paparrotada
bazofiador|fanfarrão|gabarola|paparrotão
beata|devota
beatice|santimónia
beatificado|beato|bem-aventurado|carola
bebé|recém-nascido
bebedeira|borracheira|carraspana
bêbedo|ébrio|embriagado|temulento
beber|ingerir|tomar
beberrão|borrachão|borracho
bebível|potável
beiço|lábio
beija-flor|colibri|pica-flor
beijo|ósculo
beira|beirada|borda|cercadura|extremidade|extremo|margem|orla|ourela
beira-mar|litoral|praia
beleguim|esbirro|malsim
beleza|formosura|venustidade
beliscão|belisco
belzebu|demónio|diabo|lúcifer|satanás
bem|muito
bem-aventurado|predestinado|sacro|sacrossanto|sagrado|santo|venerável
beneficiação|bonificação
benefício|favor|mercê
benéfico|lucrativo|profícuo|proveitoso|vantagoso|vantajoso
benemerente|benemérito
benevolência|benignidade|complacência|comprazimento|condescendência
benevolente|benévolo|benigno|bom|bondoso|caridoso|caritativo|clemente|generoso|humano
benzedor|curador|curandeiro|medicastro
berço|causa|início|nascimento|origem|princípio|rudimento
berrar|bradar|clamar|conclamar|gritar|ulular|vociferar|vozear
berreiro|bulha|vozearia
berro|brado|clamor|grito|voz
bestunto|cabeça|cachimónia|carola
besuntado|ensebado|gordurento|gorduroso|untuoso
bexiga|varíola
bezerro|novilho|tenreiro|terneiro
bibiografia|vida
biblioteca|livraria
bicha-solitária|ténia
bico|ponta
bilha|cântaro|moringa|moringue|quartinha
biltre|malandro|marau|mariola|patife|pulha|safardana
birrento|embirrento|rabugento|ruvinhoso
bisar|repetir
bisel|chanfro
biselado|chanfrado
bispado|diocese
bispo|papa|patriarca|pontífice|prelado|sacerdote
bissílabo|dissílabo
bitola|craveira|escantilhão|estalão|medida|norma|padrão
blasfémia|impropério
blasonar|estadear|luxar|ostentar|pavonear
blindado|impenetrável
bloco|conjunto
boa sorte|felicidade|fortuna|ventura
bobo|histrião|palhaço|truão
bocado|fatia|mica|naco|pedaço
boçal|casta
bode|cabrão
bofetada|chapada|estalada|estalo
boiar|flutuar|sobrenadar|vogar
boina|boné|capelo|chapéu
bola|esfera|globo
bolchevique|bolchevista|comunista
bolchevismo|comunismo
boldrié|talabarte|talim
boleeiro|cocheiro
bolorento|mofado
bomba|explosivo|petardo
bombardeamento|bombardeio|canhoneio
bombástico|espalhafatoso|estrondoso
bombo|zabumba
bonança|calma|calmaria
bondade|clemência|indulgência|misericórdia
bonita|formosa
borboleta|mariposa
borbotão|golfada|jacto|lufada|jorro
bordoada|cacetada|mocada|paulada|ripada
borrador|costaneira
borralho|cinzeiro
borras|fezes|lia
borrasca|intempérie|tempestade|temporal|vendaval
borrifar|orvalhar|rociar
borrifo|irroração|respingo
bosque|brenha|floresta|mata|selva
bosquejado|delineado|desenhado|esboçado|ilustrado|rascunhado
bosquejo|debuxo|esboço|rascunho
bostela|crosta|pústula
botânica|fitologia
botelha|frasco|garrafa
botequim|café|cafeeiro|cafezeiro
botequinheiro|cafezeiro
botica|farmácia
boticário|farmacêutico
boxeador|pugilista
bramar|bramir|fremir|rugir
bramido|rugido|urro
brando|frouxo|lento|vagaroso
brânquia|guelra
brasileiro|brasiliano|brasílico|brasílio
bravata|fanfarronada
bravatear|fanfarrear
braveza|bravosidade|bravura
bravo|indócil|indomável|indómito|insubmisso|invencível|rebelde
bravura|coragem|valentia
brida|rédea
briga|bulha|combate|desavença|disputa|luta|peleja|pendência|pugna|recontro
brigão|brigoso|rixador
brigar|competir|contender|disputar|litigar|pleitear|renhir|rivalizar
brilhante|cintilante|pomposo|refulgente|claro|sumptuoso|resplandecente|luminoso|lustroso|luzente|luzidio|reluzente|rútilo
brilhar|cintilar|fulgir|esplender|fulgurar|lucilar|luciluzir|luzir|prefulgir|prefulgurar|resplandecer|rutilar
brilho|cintilação|clarão|fulgor|luz
brincadeira|farra|galhofa|folgança|gracejo|folguedo|graçola|folia|risota|gaudério|pândega|reinação
brincalhão|engraçado|folgazão|folião|galhofeiro|gracioso|jovial|magano|pândego
brincar|distrair|folgar|divertir|trebelhar|entreter|galhofar|recrear
brindar|ceder|conceder|dadivar|dar|doar|facultar|obsequiar|oferecer|ofertar
brio|garbo|primor|zelo
brioso|cavalheiresco|cavalheiroso
britado|fragmentado|moído|pulverizado|triturado
britar|fragmentar|moer|pulverizar|triturar
brochura|folheto|impresso|opúsculo
bródio|patuscada
brotar|decorrer|dimanar|fluir
broto|gomo|novedio|rebento|renovo|vergôntea
bruma|cerração|névoa|nevoeiro
brunido|engomado
bruxa|feitiçeira
bruxedo|feitiçaria|malefício|sortilégio
bucólico|campesino|campestre|escarificador|pastoril
bufarinheiro|vendilhão
bugio|macaco|mono|simão|símio
buliçoso|irrequieto|tareco|traquina|traquinas|travesso|turbulento
burguesia|mediocracia
burilador|gravador
burla|dolo|fraude|intrujice|logro|ludíbrio|trampolinice|trapaça|tratantada|tratantice
burlar|despojar|falsificar|enganar|trampolinar|esbulhar|trapacear|espoliar|falsificar|fraudar|lesar|usurpar
burlesco|caricato|grotesco
burlista|fraudulento
burrice|estupidez
burro|estulto|estúpido|idiota|ignorante|imbecil|inepto|lerdaço|néscio|palerma
busca|procura
cabana|colmado|palhoça
cabecear|toscanejar
cabeço|colina|cômoro|monte|montículo|morro|outeiro
cabelame|cabeleira|chino
cabeludo|peludo|viloso
caboclo|mestiço
cabotinismo|exibicionismo|fatuidade|imodéstia
cabriola|cambalhota|pincho|pirueta|pinote|viravolta|pulo|salto
caçapo|coelho|láparo
cacarecos|cacaréus|cacos|trates
cacete|moca
cachimbar|fumar|tabaquear
cacho|racimo
cachoeira|cascata|catadupa|catarata
cachorra|cadela
cadafalso|forca|guilhotina|patíbulo
cadáver|defunto|morto|sucumbido
cadeia|calabouço|cárcere|enxovia|ergástulo|masmorra|prisão
cadência|compasso|regularidade|ritmo
cadenciado|cadencioso|ritmado
caduca|decrépita|engelhada|velha
caducar|prescrever
caduco|decrépito|nulo|morrediço|prescrito|morredouro
café|moca
cágado|tartaruga
caído|derribado|derrubado|tombado
cair|desabar|tombar
cairelar|debruar
caixilho|cercadura|guarnição|moldura|ornato|tarja
calado|embatucado|mudo|silencioso|silente
calafetar|tapar
calão|gíria|jargão
calar|embatucar|emudecer|silenciar
calçada|lajeada|lajedo|passeio
calcado|espezinhado|pisado
calçamento|pavimentação
calcante|pé
calcar|encalcar|calcetar|espezinhar|empedrar|pisar|pavimentar|sopear
calceteiro|empedrador
cálculo|cômputo|conta|operação
calejado|caloso
calhau|pedra|pedregulho|rebo|seixo
caligrafia|escrita|letra
calista|pedicuro
calmo|cómodo|descansado|despreocupado|imperturbado|remansado|repousado|sossegado|tranquilo
calmoso|estival
caluniador|detractor|difamador|ultrajador
calva|calvície|calvo|careca
cama|leito
camada|categoria|classe|estrato
camaleâo|papavento
camarote|torrinha
cambiar|comutar|mutuar|permutar|reciprocar|substituir|trocar
caminhada|estirão|jornada|marcha|passeio
campa|laje|lápide|loisa|lousa
campainha|chocalho|guizo
campeão|vencedor
campina|campo|chã|plaino|planície|planura|prado|vale|varga|vargem
canal|conduto|ducto|meato|meio|via
canalha|infame|miserável|moleque|refece|vil
canalização|encanamento
canalizar|encanar
canção|cantiga|melodia|música
câncer|cancro
candeia|lamparina|luminária
candelabro|lampadário|lustre
candura|inocência|pureza|virgindade
cangalho|canzil|pinhola
canino|cínico
cano|canudo|tubo
canonizar|enaltecer|santificar|glorificar
canoro|harmonioso|sonoro
cansativo|esgotante|extenuante|fadigoso
cantar|trovar
cantarolar|solfejar|trautear
cântico|hino|ode|poema|salmo
canto|esquina|quina
capa|capote|cobertura|envoltório|revestimento|toga
capacete|cimeira|elmo|penacho
capado|castrado
capar|castrar
capataz|feitor|olheiro|rendeiro
capelo|capuz
capitalista|numulário
capricho|obstinação|pertinácia|relutância|renitência|resistência|teimosia
cápsula|envoltório|invólucro
captura|conquista|tomada
capturado|conquistado|tomado
capturar|conquistar|tomar
cara|face|faceta|rosto|rostro
carácter|compleição|feitio|índole|jaez|temperamento
característica|particularidade|propriedade
caravana|comboio|frota
carcova|corcova|corcunda|gebo|giba
carecente|carecido|carente|falto|indigente|necessitado
carecer|necessitar|precisar
carena|quilha
carepa|caspa|chuvisco
careta|esgar|momice|trejeito|visagem
carga|fardo|trouxa
cargo|função|incumbência|missão
caridade|filantropia|humanitarismo
carimbo|chancela|selo|sinete|timbre
carmesim|encarnado|escarlate|purpúreo|rubente|rúbido|rubro|vermelho
carnagem|degoladouro|matadouro
carnal|concupiscente|consanguíneo|devasso|erótico|impúdico|lascivo|libertino|libidinosso|lúbrico|salaz
carne|mesocarpo|músculos
carnegão|carnicão
carnificina|chacina|fuzilamento|hecatombe|massacre|matança|morticínio
carnoso|carnudo|polposo|polpudo
caro|custoso|dispendioso
carpideira|pranteadeira
carpidor|mondador
carpinteiro|marceneiro
carpo|munheca|pulso|punho
carrancudo|macambúzio|melancólico|sorumbático
carregado|onusto|repleto|sobrecarregado
carreira|curso
carro|carruagem|coche|sege
carta|epístola|missiva
cartaz|edital|papeleta
cartel|monopólio|posse|privilégio
cartilha|silabário
cartomante|quiromante
carúncula|condiloma|verruga
carvalho|roble
casa|lar|mansão|morada|moradia|vivenda
casal|par|parelha
casamento|casório|consórcio|conúbio|enlace|himeneu|matrimónio|tálamo
casar|matrimoniar
casebre|choça|choupana|pardieiro
caseiro|granjeiro|rendeiro
casquilho|janota|peralta|peralvilho|pimpão|pintalegrete|sécio
casta|espécie|estirpe|família|genealogia|linhagem|qualidade|raça
castelhano|espanhol|hispânico|ibérico|ibero
castelo|fortaleza|forte
castidade|pejo|pudícia|pudor
castigado|penalizado|punido
castigar|penalizar|punir|reprimir
castigo|lição|pena|penalidade|punição
casto|digno|etéreo|grandioso|direito|platónico|imponente|honesto|puro|magnificente|honrado|majestoso|imaculado|monumental|íntegro|probo|sério
cataclísmico|catastrófico|desastroso
cataclismo|catástofre
catalogar|increver|registar
cataplasma|malagma|sinapismo
catar|espiolhar|pesquisar|procurar|sondar
categórico|decisivo|definitivo|formal|peremptório|terminante
catinga|defentina|fartum
cativar|escravizar|oprimir|tiranizar
caturra|passadista|retrógrado|saudosista
cauda|rabo
caudilhismo|galopinagem
caule|talo
causa|culpa|desculpa|justificação|motivo|pretexto|razão
causador|causante|motivador|ocasionador|originador
causar|fomentar|motivar|ocasionar|originar|promover|provocar|suscitar
cauteloso|cauto|cordato|precatado
cava|fosso|levada|rego|vala
cavaco|conversa|estilha|lasca
cavado|cavo|côncavo
cavador|escavador|furador|perfurador
cavalar|hípíco
cavalariça|cocheira|estábulo|estrebaria
cavername|esqueleto|ossada|ossamenta|ossamento|ossatura
cavilha|parafuso|prego|tarraxa
cedência|cessão|delegação|passagem|transferência|transição
cedido|doado|ofertado
cegueira|facciosismo|fanatismo
ceifador|ceifeiro|segador
cela|cubículo|quartinho
celebrado|comemorado|festejado
celebrar|comemorar|festejar
celebridade|notoriedade
celeridade|ligeireza|presteza|rapidez
celeste|celestial|celestino|etéreo|sideral|sidéreo
celha|cílio|pestana
cem|centena|século
cenobita|frade|monge
censo|recenseamento
censura|exprobação|increpação|repreensão
censurar|criticar|exprobar|objurgar|repreender|reprochar|verberar|vituperar
centelha|chispa|corisco|fagulha|faísca|faúlha
central|meão|medial|mediano|médio
centralização|concentração|convergência
centralizado|concentrado
centralizar|concentrar|convergir
centro|meio|núcleo
cepo|toro
cepticismo|descrença|pirronismo
céptico|descrente|incrédulo|pessimista
cerca|murado|muro|tapume
cercado|cingido|circunvalado|contornado|encurralado|ladeado|rodeado|sitiado
cercar|contornar|encurralar|ladear|precingir|rodear
cerdoso|erecto|hirsuto|hirto|inteiriçado|retesado|rígido|tenso|teso
cerimónia|protocolo
cerimonioso|mesureiro|respeitoso|reverencioso|reverente
cerrado|compacto|encerrado|concentrado|entupido|condensado|fechado|denso|obstruído|ocluso|selado|tapado
certame|concurso|torneio
certidão|certificado|diploma
certificar|conferir|confirmar|corrobar|reconhecer|verificar
certo|claro|evidente|manifesto|notório|patente|perceptível|visível
cerviz|nuca
cervo|corço|veado
cessar|parar|sobrestar
cetina|espermacete
céu|firmamento
chácara|granja
chacota|chufa|joguete|ludíbrio|mofa|motejo|remoque|troça|zombaria
chaga|ferida|úlcera|ferimento|lesão
chagado|ulcerado
chagar|ulcerar
chalaça|graça|laracha|piada
chalacear|chocarrear|gracejar|rir|sorrir
chalrar|chalrear|chilrar|chilrear|piar|pipilar
chama|labareda
chamamento|convocação|solicitação
chamar|invocar
chamariz|engodo|isca
chão|pavimento|soalho|solo
chapa|placa
charneira|dobradiça|gonzo
chato|liso|macio|plano|raso|rente|rés
chavelho|chifre|corno
chefe|director|dirigente|encarregado|gerente|patrão|superintendente
cheia|enxurrada|enxurro
cheio|pleno|referto
cheirar|farejar|rescender
chiar|cuincar|ganir|uivar|ulular
chibata|vara|verdasca|vergasta
chicana|enredo|intriga|mexerico|trama|tramóia|trica
chifres|cornos
chilreador|gárrulo|gorjeador
chilreio|chilro
chiste|facécia|pilhéria
chocadeira|incubadora
chocar|germinar|incubar|pupular
chorado|lastimado|pranteado
choramingar|chorar|lacrimejar|lagrimejar|prantear
choramingas|chorão
choro|pranto
chuchurrear|gorgolejar
chumaço|tampa
chusma|tripulação
chute|chuto|pontapé
chuviscar|molinhar
chuvoso|pluvial|pluviátil|pluvioso
cibalho|cigalho|migalha
cicerone|guia
cício|murmuração|murmúrio|sussurro
ciclone|furacão|tufão
ciente|consciente|cônscio
cientista|investigador|observador|pesquisador
cifra|zero
cinismo|desaforo|descaramento|desfaçatez|impudência
cinta|cinto|cinturão
cinzel|escopro
cinzelado|entalhado|esculpido|gravado
cinzelar|entalhar|esculpir|gravar
ciranda|joeira|peneira
cirandar|joeirar|peneirar|tamisar
circuito|giro|rodeio|rotação|volta
circular|circundar|circunvalar|rodear
circundado|circunvalação
circunferência|periferia
circunlóquio|perífrase|pleonasmo
circunscrição|perímetro
circunstância|condição|estado|situação
circunstanciar|detalhar|esmiuçar|pormenorizar
círio|vela
cismar|cogitar|considerar|cuidar|discorrer|matutar|meditar|pensar|ponderar|raciocinar
citar|referir|reportar
ciúme|emulação|inveja
civil|social
civilidade|urbanidade
civilização|cultura
civilizado|urbano
civismo|nacionalismo|patriotismo
clandestino|furtivo|ilegal
clareza|nitidez|perspicuidade|transparência
claro|evidente|simples
classificar|qualificar
claudicar|coxear|mancar|manquejar
clausura|encarceramento|recolhimento
climático|climatológico
clímax|orgasmo
clínico|galeno|médico
cloaca|latrina|retrete|sentina
co-autor|comparte|quinhoeiro|sócio
co-participação|conivência|cumplicidade
co-proprietário|condómino
coação|filtração
coadjuvar|colaborar|cooperar
coador|crivo
coagido|constrangido|imposto
coagir|constranger|forçar|obrigar
coagulado|coalhado
coagulador|coágulo|coalho
coar|escoar|escorrer|filtrar
cobarde|covarde|medroso|poltrão|temeroso
coberto|enroupado|resguardado|vestido|tapado
cobra|ofídio|serpente
cobrir|deter|ocultar|entupir|resguardar|estancar|revestir|tapar|tapulhar|vedar
coça|maçada|sova|surra|tareia|tunda
coçado|cotiado|gasto|rafado|raspado|roçado
coçar|comichar|pruir|prurir|titilar
coceira|comichão|pruído|prurido|sarna
coerência|conformidade|congruência
coerente|congruente|harmónico
coetâneo|coevo|contemporâneo
coexistência|simultaneidade
coima|multa
colar|grudar
colateral|paralelo
colecção|compilação|repertório
colecta|colheita|safra
colectar|tributar
colégio|escola
cólera|exacerbação|gana|exasperação|ira|irritação|malquerença|ódio|odiosidade|raiva|rancor|sanha
colo|pescoço
colocado|disposto|posto
colóquio|conversa|conversação|diálogo|palestra
colorante|corante
colorido|cromatizado|matizado|pintado|sarapintado|tingido|variegado
colorir|cromatizar|matizar|pintalgar|pintar|tingir|variegar
coluna|pilar|poste|pilastra
combustão|esbraseamento
começar|debutar|encetar|estrear|inaugurar|iniciar|principiar
começo|início|prelúdios|primícias|primórdio
comedimento|moderação
comemorativo|rememorativo
comensal|convidado|conviva
comentário|glosa|observação
comer|consumir|manducar
comercial|mercantil
comerciante|mercador|mercante|negociante|tratante
comerciável|comprável|negociável
comércio|negócio|transacção
cómico|engraçado
comilão|glutão|guloso|lambão|regalão
comiseração|compaixão|dó|dó|lástima|enternecimento|pena|maviosidade|meiguice|miseração|piedade|ternura
comissão|percentagem
como|porquê|uma vez que
comovedor|comovente|enternecedor
comover|emocionar|enternecer|impressionar
compaixão|condolência|dor|pesar
comparação|conferência|confrontação|verificação
comparar|confrontar
comparecimento|comparência|presença
comparsa|parceiro|sócio
compartimento|divisão
compatível|comportável|conciliável|harmonizável|patível
compatrício|compatriota|concidadão|conterrâneo|patrício
compelido|empurrado|impelido
compêndio|epítome|resenha|resumo|sinopse|síntese|sumário|súmula
compenetrado|concentrado|ensimesmado
compensação|indemnização|ressarcimento
compensar|gratificar|indemnizar|recompensar|ressarcir
competência|conhecimento|cultura
complexidade|complicação|dificuldade
complexo|multíplice
compor|conceber|criar|imaginar|inventar
composição|constituição|elaboração|formação
composto|constituído|formado
comprazer|condescender|contemporizar|transigir
compreendido|entendido|percebido
comprido|extenso|longo
comprimir|estancar|reduzir|obstringir
comprobativo|comprobatório|comprovativo
comprovador|comprovante|probante|probatório
comprovar|fundamentar|justificar|provar
compungido|magoado|torturado
compungir|enternecer
comum|generalidade|geral
comunhão|comunidade|confraria|congregação|irmandade|sociedade
comunicação|informação|notícia
comunicado|enviado|expedido|transmitido
comunicador|comunicante|participador
comunicar|conversar|enviar|discursar|expedir|exprimir|legar|falar|remeter|orar|transmitir
comuta|mudança|permuta|troca
comutação|permutação|substituição
concatenar|engranzar
concedido|facultado|outorgado
conceito|concepção|noção
conceituado|reputado
conceituoso|espirituoso
concessão|licença
concessor|dador|doador
concha|valva
conciso|curto|lacónico|resumido|sintético|sucinto
conclusão|desenlace|desfecho|epílogo|peroração
conclusivo|ilativo
concreção|condensação|solidificação
concupiscência|incontinência|lascívia|luxúria
condão|dom|faculdade|virtude
condecoração|divisa|medalha
condenação|pena
condenado|réprobo|sentenciado
condenar|desaprovar|improbar|reprovar|sentenciar
condição|exigência|quesito|requisito
condolências|pêsames
condução|meio|transporte
conducente|tendente
conduzido|levado|orientado|transportado
conecção|conexão|ligação|nexo|vínculo
confeiteira|doceira
confessar|revelar
confiança|crédito
confiante|esperançado|esperançoso|optimista|positivo
confiar|encarregar|incumbir|responsabilizar
confidencial|secreto
confidenciar|segredar
configuração|feição|feitio|forma|formato
confinante|fronteiro|limítrofe|lindeiro
confluir|convergir
conformado|resignado
conformar|resignar
confortador|consolador|dulcificador|dulcificante
congelado|enregelado|gelado|gélido|glacial|regelado
congelador|frigorífico|geladeira|refrigerador
congelamento|frigoríficação|refrigeração
congelar|enregelar|gelar|gelificar|regelar
congeminar|diversificar|irmanar|multiplicar|pluralizar
congénito|inato|ingénito|natural
congraçar|harmonizar|pacificar|reconciliar
congratulações|cumprimento|felicitação|parabém|parabéns|prolfaça
congratular|cumprimentar|felicitar|salvar|saudar
congressista|deputado|parlamentar|parlamentário
conhecedor|experiente|experimentado|inteligente|matraqueado|perito|prático|sabedor|versado
conhecer|saber
conhecido|divulgado|espargido|publicado|sabido
conivente|conluiado|cúmplice|parcioneiro
conjectura|hipótese|prognose|pressuposição|prognóstico|pressuposto|presunção|suposição
cônjuge|consorte
conjuntivo|subjuntivo
conjuntura|ensejo|lance
conjurar|esconjurar|exorcismar|exorcizar
conjuro|esconjuro|exorcismo
conquanto|não obstante|posto que
conquistar|invadir|ocupar
consagração|glorificação
consagrar|devotar|sagrar
consecutivo|continuado|contínuo|ininterrupto|seguido|sucessivo
conselheiro|mentor
conselho|juízo|recomendação|parecer
conserva|defende|guarda|retém|vigia
conservar|guardar|poupar|preservar|resguardar
consolidar|solidar|solidificar
conspirar|enredar|intrigar|maquinar|tramar|urdir
conspurcar|poluir
constância|perseverança|persistência|tenacidade
constante|estável|metódico|jacente|ordenado|manente|regular|permanente|uniforme
constantemente|continuamente|incessantemente|sempre
consternado|desgostoso|infeliz|prostrado|triste
constranger|estuprar|violar|violentar
construir|edificar|erigir
consubstanciar|unificar|unir
consuetudinário|costumário|costumeiro|habitual|habitual|normal|usual
contado|descrito|exposto|narrado|relatado
contadoria|pagadoria|tesouraria
contagem|descrição|enumeração|escrutinação|descrição|escrutínio|narração|relato|resenha
contagiado|contaminado|eivado|infeccionado|infectado|infecto|inficionado
contagiar|contaminar|gafar
contagioso|transmissível
contar|descrever|narrar|racontar|recontar|relatar
contemporização|tolerância|transigência
conter|moderar|sofrear|sustar
contestação|contradição|impugnação|impugnação|oposição|negação|protesto|objecção|queixa|reclamação
contestado|contraditado|contrariado|impugnado|negado|respondido
contestar|contraditar|contrariar|impugnar|negar|responder
contestável|controvertível|discutível
conteúdo|teor
contingente|efêmero|interino|passageiro|precário|provisório|temporário|transitivo|transitório
continuação|prolongação|prolongamento|prosseguimento
continuidade|ininterrupção|perenidade|perpetuidade
conto|história|narrativa|raconto
contorcer|dobrar
contorno|perímetro
contradição|incoerência|incongruência
contraditar|contrapor|denegar|desmentir|refutar
contrafacção|imitação|plágio
contrariado|forçado|obrigado
contrariedade|contratempo|dificuldade|obstáculo
contraventor|infractor|transgressor|violador
contribuição|imposto|taxa|tributo
contribuinte|tributário
controverso|discutível|duvidoso|incerto|questionável
contudo|mas|porém|todavia
contundido|molestado
contusão|equimose|pisadura|traumatismo
conubial|matrimonial|nupcial
convencido|convicto
conveniente|profíquo|útil
converso|convertido
converter|metamorfosear|transformar|transmudar|transmutar
convicção|crença|persuasão|fé
convidar|convocar|invitar
convincente|persuasivo|suasivo|suasório
convite|invitação
convivência|convívio
copa|despensa
cópia|imitação|transcrição|reprodução|traslado
copiador|copista|escrevente
copiar|imitar|plagiar|reproduzir
copioso|diverso|variado|vário
coquetismo|faceirice|garridice|louçania
corado|ruborizado
corajosamente|denodadamente|ousadamente|valentemente
cordame|cordoalha
cordilheira|serrania
coriscar|relampaguear|relampejar
corja|escória|escumalha|gentalha|malta|plebe|ralé
corneta|trombeta|tuba
coroa|diadema|grinalda
coroar|galardoar|laurear|premiar
corpulência|espessura|grossura
corpulento|encorpado
correcção|emenda|expurgação
corredor|galeria
córrego|regato|riacho|ribeiro
correlação|interdependência|reciprocidade
corrente|fluente|manante
correr|decorrer|passar|percorrer
corrigido|revisto
corrigir|emendar
corroborado|reforçado
corroer|desgastar
corromper|peitar|subornar
corrosivo|erodente|erosivo
corrupção|depravação|devassidão|prevaricação
corsário|pirata
cortado|desagregado|rachado|retalhado|desassociado|despegado|desunido|dissociado|separado
cortar|trinchar
corte|galanteio|golpe|namoro|incisão
cortejar|galantear|namorar
cortesias|cumprimentos|mesuras|salamaleques
cortina|cortinado
costado|costas|dorso|espinhaço|serro
costume|hábito|prática|rotina|uso
costureira|modista
cota|prestação|quinhão|quota
couro|epiderme|pele
covardia|fraqueza|medo|pusilanimidade
coveiro|enterrador|sepultureiro
cozimento|decocção
crápula|deboche|desregramento|devassidão|libertinagem|tripúdio
cravado|encravado|espetado
cravar|espetar|fincar|pregar
crente|piedoso|religioso
crepúsculo|lusco-fusco|ocaso
crescido|desenvolvido
crescimento|desenvolvimento|incremento|prolongamento|propagação
cretino|lorpa|otário|pacóvio|papalvo|parvo|pascácio|pato|sonso|tanso
criação|geração
criador|fundador|instituidor|pai
criança|gaiato|garoto|menino|moço|moçoilo|muchacho|párvulo|petiz|rapaz
criançada|criancice|pequenada
criancice|infantilidade|ingenuidade|puerilidade
criançola|pirralho|rapazelho|rapazete|rapazola
criar|fabricar|gerar|produzir
criatividade|originalidade
criatura|indivíduo|pessoa
crime|delito|transgressão|violação
crispar|franzir
crítica|sátira
crocitar|grasnar
cronista|historiador|historiógrafo
cruciar|martirizar
cruento|ensanguentado|sangrento|sanguinolento
cruzamento|intercepção|interceptação
cuidado|desvelo|zelo
cuidadoso|diligente|escrupuloso|melindroso|solícito|zeloso
cujo|das quais|de quem|do qual|dos quais|tal qual
culto|douto|doutrinado|erudito|ilustrado|instruído|letrado|literato|luminar|sábio
cultuar|idolatrar|venerar
cumprir|executar|satisfazer
cúmulo|montão
cupim|térmita
cura|tratamento|trato
curar|medicar|remediar|sanar|sarar|tratar
curável|remediável|sanável|tratável
curto|limitado|pequeno
curvar|desnivelar|inclinar|pender
curvatura|inflexão
cuspir|esputar|salivar
custo|dispêndio
dactilografia|mecanografia
dactilógrafo|mecanógrafo
dádiva|doação|donativo|esmola|oferta
dadivoso|generoso|liberal|magnânimo|munificente|munífico
dado|oferecido
dalmática|túnica
dama|mulher|senhora
danoso|fatal|funesto|grave|infesto|lesivo|maléfico|maligno|mau|nefasto
dardo|flecha|venábulo|lança|seta
de agora em diante|doravante|para o futuro
deambular|divagar|flanar|passear|perambular|vagabundear|vaguear
debaixo de|por baixo de|sob
debalde|em vão|inutilmente
debatido|discutido
debicar|dentar|depenicar|lambiscar|morder|mordiscar|petiscar|trincar
débil|doentio|enfermiço|entorpecido|insalubre|malsão|mórbido|morbífico|morbígeno|morbígero
década|dez|dezena
decapitação|degola|degolação
decapitado|degolado
decapitar|degolar|descabeçar|guilhotinar
decência|decoro|dignidade|honestidade|honradez|integridade|probidade|pudicícia|rectidão|respeitabilidade
decepado|estropiado|mutilado
decepção|desengano|engano|desilusão|logro|recusa|taboca
decepcionado|desapontado|desenganado|desesperançado|desiludido
decesso|definhamento|estiolamento|falecimento|falecimento|morte|óbito|passamento|perecimento
decidido|deliberado|disposto|determinado|resolvido|sentenciado
decidir|deliberar|resolver|determinar|sentenciar
decifrar|interpretar
declamação|recitação
declaração|enunciação
declarado|dito|enunciado|proferido|pronunciado
declarador|declarante|depoente
declive|escarpa|rampa|ribanceira|talude
decompor|desagregar|desintegrar|dissociar|dissolver
decomposição|desagregação|dissolução
decomposto|fétido|podre|putrefacto|pútrido
decorrer|decurso|discurso|percurso|transcursão|transcurso
decretar|estatuir|legislar|preceituar
dedicado|devotado
dedicar|destinar
deduzido|inferido
deduzir|descontar|inferir
defeituoso|falho|imperfeito|pechoso
defender|proteger|tutelar|tutorar
defensável|defensível|defensivo
defensor|padroeiro|patrono|protector
defesa|resguardo
definhado|peco
defraudação|falsificação|usurpação
defronte|diante|na frente
defumar|fumar|fumegar
degenerado|depravado|pervertido
deglutição|ingestão
deglutir|engolir
degredado|deportado|desterrado|exilado|expatriado|proscrito
delambida|intrometida|lambisgóia|mexeriqueira
delegado|mandatário|procurador|representante|solicitador
deleite|delícia
delgado|fino|franzino|magro|ténue
delicado|frágil|quebradiço|quebrável
delimitador|demarcados|engendrar|esboçar|idear|planear|planejar|preconceber|projectar
delineação|delineamento
deliniado|esboçado|ideado|planeado|planejado|preconcebido|projectado
delíquio|desfalecimento|desmaio|esmaecimento|lipotimia|síncope
delongador|prorrogador|protelador
demandar|exigir|inquirir|requerer|interrogar|requisitar|perguntar|solicitar
demasia|excedente|excesso|remanescente|restante|resto|sobejo|sobra|troco
demasiado|exagerado|excessivo|muito|sobejo
demissão|deposição|destituição|exoneração
demitido|deposto|despedido|destituído|exonerado
demitir|desobrigar|desonerar|destituir|dispensar|eximir|exonerar|isentar|livrar|prescindir
demolir|desfazer|desmanchar|desmantelar|destruir
demoníaco|diabólico|endiabrado|infernal|maquiavélico|satânico|terrível
demonstração|mostra|prova
demonstrar|provar
demora|lentidão|morosidade|vagar
denodado|impávido|impetuoso|intrépido|ousado
dentição|odontíase
dependência|obediência|sujeição|submissão|subordinação|sujeição
depilatório|epilatório
deplorar|lamentar|lastimar
deplorável|detestável|lastimável
depoimento|prova|testemunho
depósito|repositório
depreciação|desabono|descrédito|desdoiro|desfavor|menoscabo
depreciar|pejorar
derivar|efluir|emanar|provir
derradeiro|último
derramado|entornado|espalhado
derramamento|efusão
derramar|entornar|espargir|esparzir|verter
derrear|derrengar|descadeirar|deslombar
derreter|liquefazer|liquidificar
derretido|liquefacto|liquefeito
derrota|guia|guião|itinerário|rota|roteiro
derrotável|vulnerável
desabafar|desafogar|desoprimir
desabituar|desacostumar|desafazer|desavezar
desabrido|tarasco
desacautelado|estouvado|estúrdio|improvidente|imprudente|incauto
desacertar|desarmonizar|desconcertar
desacerto|engano|equívoco|erro|incorrecção
desacreditado|desconceituado
desafiador|provocador|reptador|reptante
desafinação|desentoação|dissonância
desafinado|desentoado
desafio|duelo|repto
desafortunado|desditoso|desgraçado|desventurado|infausto|infeliz|infortunado|mal-afortunado
desafrontar|desagravar|desforrar|desforçar|despicar|vingar
desagarrar|desatrelar|desenganchar|desengatar|desligar|despegar|desprender|soltar
desagradar|desgostar
desagradável|repugnante
desagregação|desanexação|desintegração|desmembração|desmembramento|desunião|fragmentação|secessão|separação
desagregar|dissocear
desajeitado|desastrado|desenxabido|desgracioso
desalentador|desanimador
desalentar|desanimar|esmorecer
desalinho|desleixo|desmazelo
desandar|recuar|retroceder|retrogradar|retrogredir|retrosseguir
desaparafusar|desatarraxar|desparafusar
desaparecer|desvanecer|vanescer
desaparecido|perdido|sumido
desapiedado|desumano|inumano
desapossar|desapropriar|desempossar|expropriar|privar
desaprovado|inabilitado|reprovado
desarmado|desmanchado|desmontado
desarmonia|discordância|discórdia|discrepância|dissonância|divergência|divergência|inconsonância
desarranjar|desconcertar
desarrazoar|desatinar|despropositar|disparatar|tresvariar
desastre|sinistro
desatado|desembaraçado|solto
desatar|desdar
desatravancar|desembaraçar|desimpedir|desobstruir
desautoração|desprestigio
desautorar|desautorizar|exautorar
desavergonhado|despudorado|desvergonhado|impudente
desbaratar|desperdiçar|esbanjar|malbaratar|malgastar|prodigalizar|prodigar
desbarato|desperdício|dissipação|dissipação|esbanjamento
desbotar|descolorir|descorar
descaído|inclinado|pendido
descaminho|extravio|sumiço
descansar|repousar|resfolgar
descanso|folga|sota
descaramento|descomedimento|desonestidade|safadeza|insolência|desvergonha|petulância|imoralidade|protêrvia|torpeza
descascar|esbrugar|esburgar|pelar
descendência|filiação|geração|prole|sucessão
descendente|progénito
descoberta|invenção
descoberto|desvelado|revelado
descobridor|inventor
descobrir|desenredar|deslindar|desvendar
desconexo|desligado|incoerente|desunido|inconsequente
desconfiado|intrigado
desconfiança|suspeição|suspicácia
desconfiar|duvidar|suspeitar|hesitar|vacilar
desconhecido|ignoto|incógnito
desconhecimento|ignorância
desconsideração|desdém|desprezo
desconsiderar|desprezar|menosprezar|preterir
descontentamento|insatisfação
descontinuação|interrupção|paralisação|suspensão
descontinuado|interrompido
descontinuar|interromper|suspender
descontínuo|interrompido
descontraído|relaxado
descorar|empalecer|empalidecer
descortesia|grossaria|grosseria|impolidez|incivilidade|indelicadeza|inurbanidade
descortiçar|escorchar
descortino|perspicácia
descritor|narrador|relator
descuidado|desleixado|desmazelado|negligente
descuidar|descurar|desleixar|negligenciar|relaxar
descuido|imprevidência|imprevidência|inadvertência|inadvertência|incúria|incúria|negligência|negligência
desculpável|perdoável|venial
desdita|desventura|infelicidade|infortúnio
desdito|desmentido
desdoiro|desdouro|desonra|labéu|queda|vergonha
desejo|libido
desembaraçar|desenvencilhar|livrar|safar
desempoar|desempoeirar
desencaminhar|extraviar|transviar
desenfadado|desenfastiado
desenfreado|desordenado|desregrado|infrene
desenganar|desengodar|desesperançar|desiludir
desenhador|desenhista
desenhar|riscar|traçar
desenho|esboço|estampa|escorço|figura|traçado|gravura|ilustração|imagem
desenterramento|exumação
desentumecer|desinchar
desertar|transfugir
desertor|fugitivo|prófugo|transfuga
desfalecer|desmaiar|esmaecer|esvaecer
desfalecido|desmaiado|desvanecido|esvaído|exânime|moribundo|mortiço
desfalque|desvio|falcatrua|negociata|traficância|velhacaria
desfeito|dissoluto|dissolvido
desforço|desforra|represália|retaliação|vingança
desfragmentado|despedaçado|dividido|partido|quebrado
desfragmentar|despedaçar|dividir|partir|quebrar
desfrutar|gozar|usufruir
desfrute|fruição|gozo|usufruição|usufruto
desgosto|desprazer|dissabor
desguardar|desguarnecer|desmobiliar|desproteger
desguarnecido|desprotegido|desprovido
designado|eleito|nomeado
designar|escolher|nomear
desígnio|destino|finalidade|intenção|intento|propósito|tenção
desleixado|displicente|relaxado
deslindado|explanado|justificado
deslizar|escorregar|resvalar
deslocação|movimento
deslocar|mudar|transferir|transladar|transmitir|trasladar
deslumbramento|esplendor|fulgência|magnificiência
deslumbrante|esplendente|esplêndido|fantástico|feérico|magnificiente
deslumbrar|encantar|fascinar|maravilhar
deslustrar|embaciar
desmamado|exúbere
desmedido|desproporcionado
desmerecer|perder
desmoralizar|perverter
desnudar|despir|despojar|desvestir
desnudo|despido|nu|pelado
desnutrição|fome
desobedecer|infringir|postergar|recalcitrar|transgredir|violar
desobediência|indisciplina|insubmissão|insubordinação|rebelião|subversão
desobediente|indisciplinado|insubordinado
desobrigado|dispensado|isento|liberto
desocupado|devoluto|livre|vago
desocupar|vagar|vazar
desonesto|indecente|indecoroso|indigno|vergonhoso
desonra|ignomínia|infâmia|opróbrio
desordenar|desorganizar|revolver
despedaçamento|dilaceração|laceração
despedaçar|esfanicar|esfarrapar|esfrangalhar
despejado|estanco|esvaziado
despejar|esvaziar|evacuar
despejo|detrito|lixo|resíduo
desperdiçado|esbanjado|esperdiçado
desperdiçador|esbanjador|esperdiçador|gastador|perdulário
despersuadir|dissuadir
despojador|espoliador
despojo|espólio
despótico|opressor|prepotente|tirânico|tirano
desprecatado|desprevenido
despropositado|disparatado
despropósito|impertinência|importunação|inconveniente|inoportunidade
desregrado|dissoluto|libertino|licensioso
destacado|engrandecido|evidenciado|realçado
destacar|evidenciar|primar|realçar|ressaltar|sobresair
destilar|estilar|exsudar|porejar|ressumar|ressumbrar
destinado|talhado
destino|direcção|fado|orientação|sorte|rumo|tramontana
destruição|devastação|ruína
destruidor|vândalo
desusado|inusitado
desvanecer|vangloriar
desvelar|diligenciar|empenhar|esforçar
desvio|meandro|ramal
detalhe|pormenor
deter|estagnar|estancar|paralisar
deteriorar|estragar|gastar|inutilizar
determinação|formalidade|lei|mandamento|norma|preceito|regra
determinar|estabelecer|instaurar|instituir|mandar|ordenar|prescrever
detido|estagnado|impedido|represado|retido|suspenso
detonação|explosão
deusa|diva|divindade
devagar|lentamente|vagarosamente
devaneador|fantasista|sonhador|utopista|visionário
devanear|fantasiar|idear|sonhar
devaneio|fantasia|ficção|ilusão|imaginação|quimera|sonho|visão
dever|obrigação|responsabilidade
devesa|souto|tapada
devolução|reembolso|restituição
devolver|entregar|repor|restituir
devorador|edaz|voraz|voraz
devorar|engolir|lambear|lamber|tragar
devoto|fanático
dextra|direita
diabrura|maldade|malícia|traquinice|travessura
diáfano|límpido|translúcido|transparente
diagonal|oblíquo
dianteira|frente|vanguarda
diário|quotidiano
dicção|expressão|vocábulo
dicionário|léxico
dicionarista|lexicólogo
dicionarizar|lexicografar
didactologia|pedagogia
difamação|maledicência|mordacidade
diferençar|diferenciar|discernir|discriminar|distinguir
diferente|dissemelhante
diferir|discordar|discrepar|divergir
difundido|disperso|disseminado|espalhado|esparso
difusão|disseminação|divulgação|espalhamento
digestivo|estomacal
digital|do dedo
digladiar|esgrimir
dignidade|distinção|honra|pundonor
digressão|divagação|excursão|passeata|passeio
dilacerado|lacerado
dilacerar|lacerar|rasgar
dilapidador|dissipador
dilatado|expandido
dílatável|expansível
dilatório|moratório
diminuição|subtracção
diminuído|minguado
diminuto|escasso|inaudito|insuficiente|parco|raro|vasqueiro
dinheiro|moeda|numerário|quantia|verba
direito|recta
dirigir|encaminhar|guiar
discernimento|discrição|recato
disconforme|disforme
discordante|discorde|discrepante|divergente
discreto|humilde|modesto|recatado|simples
discurso|exposição|oração
discutidor|questionados
disfarçado|dissimulado|embuçado|encapotado|mascarado|osco
disfarçar|dissimular|embuçar|encapotar|encobrir|esconder|mascarar|paliar
disfarce|dissimulação|máscara|socapa
dispensário|dispensatório
dispersão|dissipação
dispersar|dissiminar|dissipar|espalhar
dissolução|rescisão
distância|intervalo
distanciado|longe
dístico|etiqueta|letreiro|rótulo
distinção|elevação|eminência|evidência|realce|relevo|saliência
distinguir|enobrecer|honrar|notabilizar
distintivo|emblema|insígnia|marca|símbolo
distinto|egrégio|exímio|ilustre|ínclito|insigne|nobre|notável
distracção|diversão|divertimento|entretenimento|passatempo|recreio
distribuir|partilhar|repartir
distrito|província|região
diurnal|diurno
diversidade|flutuação|heterogeneidade|multiplicidade|inconstância|pluralidade|variação|variedade|volubilidade
diversificar|variar
diversivo|revulsivo|revulsório
divertido|jocoso|recreativo|risonho
divindade|nume|potestade
divisa|lema|mote
divisão|partilha|ramificação|repartição|separação|subdivisão
divulgar|propalar|publicar|vulgarizar
dizer|expor|expressar|manifestar|proferir
dobra|prega|refolho|vinco
dobrar|duplicar|flectir|geminar|inflectir|vergar
dobro|duplo
doce|gula|gulodice|guloseima|gulosice|rebuçado
doçura|mel
domicílio|estância|habitação|morada|residência
dominado|escravizado|subjugado|submetido
dominador|dominante
dominável|superável|transponível|vencível
donairoso|galhardo|garboso
dono|possessor|possuidor|possuinte|proprietário
dose|ração
dosologia|posologia
dossel|pálio
doutrina|ensinamento|fundamento|princípio|teoria
duendes|espectros|fantasistas|lémures
duplicação|geminação
duplicado|geminado
durabilidade|duração|espaço
duradouro|eterno|infindável|perdurável|perenal|perene|perpétuo|sempiterno
durar|insistir|resistir|perseverar|persistir|porfiar
durável|indelével|indestrutível|inextinguível
dureza|rijeza
dúvida|incerteza
ebriedade|embriaguez
eco|repercussão
ecoar|repercutir|repetir
económico|parcimonioso|poupado
economizar|forrar|poupar
edificação|fundação|instituição
edifício|prédio
edil|vereador
educação|ensino|instrução
efebo|mancebo
efectuar|elaborar|executar|fazer|realizar
efélide|sarda
eficácia|eficiência
eficaz|eficiente
efígie|individualidade|personalidade|vulto
egoísta|interesseiro
egotismo|subjectivismo
égua|guincha|poldra|potra
eira|eirado|terraço|terrado|terreiro
elasticidade|flexibilidade
elefantíase|lepra|morfeia
eleger|escolher|optar|seleccionar
eleitor|sufragista|votante
elementar|rudimentar
elevado|proeminente|ressaltado|saliente
elevar|elogiar|erguer|enaltecer|levantar|encomiar|soerguer|engrandecer|solevantar|exaltar|solevar|gabar|sublevar|louvar|preconizar|vangloriar
eliminar|expelir|expulsar|varar
eliminatório|supressivo|supressório
elite|escol
elo|gavinha
elogio|encómio|gabo|hosana|loa|louvor|panegíricio|preconização
elogioso|laudativo|laudatório
eloquente|grandiloquente|magníloquo
elucidado|esclarecido
em tal grau|tal maneira|tanto|tão
emagrar|emagrecer
emaranhado|enredado|inextricável
embaciamento|opacidade
embair|enganar|engazupar|iludir|lograr|ludibriar|mentir
embaixador|emissário|legado|mensageiro
embebedar|embriagar|inebriar
embeber|encharcar|ensopar|molhar
embebido|empapado|encharcado|ensopado|molhado
embeiçar|enrabichar
embevecer|encantar|enlevar|extasiar
embevecido|encantado|enlevado|extasiado
embolorar|embolorecer
embrulhar|empacotar|enfardar|entrouxar
embrulho|pacote
embutido|encaixado|encastoado|encravado|marchetado
embutir|marchetar|tauxiar
emergir|surdir
emético|vomitivo|vomitório
emigração|êxodo
emigrador|emigrante
emigrar|homiziar
emitir|enunciar|exprimir
emoldurar|encaixilhar
emoliente|molificante|molitivo
empanturrado|empanzinado
empanturrar|empanzinar
emparelhar|jungir
empedernir|empedrar|endurecer|enrijar|obdurar|petrificar
empenhado|hipotecado
empenho|esforço|interesse
emplumado|plúmeo
empoeirado|poeirento|polvoroso|pulveroso|pulverulento
empolado|enfático
emporcalhar|enodoar|enxovalhar|laivar|macular|manchar|sujar
emprego|ocupação|ofício|serviço|tarefa|trabalho
empreiteiro|tarefeiro
empurrar|empuxar|puxar|repuxar
emugrecer|enferrujar
emurchecer|mirrar|murchar|ressequir|secar
emurchecido|mirrado|murcho|ressequido|seco
encadeamento|série|sucessão
encaixe|juntura
encalacrado|entalado
encalacrar|entalar
encalço|indignação|pegada|peugada|pista|rasto|rastro|treita|trilha
encaminhado|guiado
encantado|seduzido
encanto|feitiço|maravilha|magia|portento
encargo|incumbência|legado|obrigação|ónus|pensão
encastoar|engastar
encerado|oleado
encerramento|fechamento|fecho
encerrar|fechar
enchimento|recheio
enciclopedista|pantólogo
encostado|reclinado|recostado
encostar|reclinar|recostar
encovar|enterrar|inumar|sepultar|tumular
encrespado|enrufado|enrugado
encrespar|enrufar|enrugar
endemoninhado|energúmeno|possesso|possuído
endentar|engrenar|entrosar
endovenoso|intravenoso
energia|força|vigor|pujança|virilidade|robustez|vontade
enérgico|veemente
enevoado|nebuloso|nevoento|nubiloso|nublado|nuvioso
enevoar|entenebrecer|nublar|obnubilar|obscurecer
enfadar|importunar|incomodar|inquietar|molestar
enfadonho|enfastioso|fastidioso|fastisioso|fatigante|maçante|maçudo|monótono|tedioso
enfatuado|fátuo
enfeizar|engabelar|engambelar|engavelar
enfezado|entanguido|raquítico
enfiar|incluir|incorporar|inserir|introduzir|meter
enfraquecimento|esgotamento|extenuação|prostração
enganado|equivocado|iludido|ludibriado|traído
enganador|enganoso|equivocador|traidor
engano|ilusão|miragem
engarrafar|envasar|envasilhar
engasgo|sufoco
engatinhar|gatinhar
engelhado|enquerquilhado|enrugado
engenho|talento
engenhoso|habilidoso|inventivo|talentoso
engrossar|espessar
engulho|enjoo|náusea
enigma|esfinge|mistério
enigmático|esfíngico|misterioso|místico|sibilino
enlaçado|entrançado|entrelaçado|trançado
enlaçar|entrelaçar|laçar
enleio|perplexidade
enobrecimento|nobilitação
enodoado|maculado|maculoso
enredador|intrigante|mexeriqueiro
enroupar|entrajar|trajar|vestir
ensaio|experiência|experimento|tentativa
ensamblador|entalhador|inscultor
ensecar|esgotar|esvaziar|exaurir|haurir
ensombrado|obscurecido|ofuscado
ensombrar|enturvar|escurecer|ofuscar|turvar
entabuar|entabular|estacar
entalha|entalhe|talha
então|logo|portanto
enterramento|enterro|funeral|inumação|mortório|saimento|sepultamento
entoação|tinido|toada|tom
entoar|repercutir|ressoar|tocar
entomologia|insectologia
entorpecente|estupefaciente
entorse|estorcegão|torcedura
entortar|enviesar|revirar|torcer
entrada|ingressão|ingresso
entrançar|entretecer
entranhas|intestino|vísceras
entrecasca|líber
entrementes|entretanto
entremeter|intercalar|interpor
entrevação|entrevamento|paralisia|tolhimento
entrevado|paralítico|tolhido
entrever|prever
entufar|tufar
entumescido|inchado|intumescente|intumescido|tumefacto|túmido|túrgido
entupimento|obstrução|obturação
entupir|obstruir|obturar
entusiasmo|exalo|exaltação|excitação
envenenamento|intoxicação
envolto|envolvido
enxofrar|sulfurar
enxofre|súlfur
enxuto|seco
épico|heróico|homérico
epígrafe|título
episódio|incidente
época|era|estação|idade|quadra
epopeia|poema
equanimidade|imparcialidade|neutralidade
equidade|isenção|justiça
equilibrar|lastrar
equilíbrio|estabilidade
equilibrismo|malabarismo
erário|tesouro
erecção|levantamento
erguido|levantado
errado|falso|incorrecto|inexacto|inverídico
erudição|sabedoria|saber|sapiência
erva|grama|relva
ervanário|herbanário
esbater|relevar
esbrasear|inflamar|queimar|tisnar|torrar|tostar
esbulho|espoliação|expropriação
esburacado|furado|perfurado|roto
escala|graduação
escancha|passada|passo
escanchar|escarranchar|escarrapachar
escaninho|esconderijo|latíbulo|recanto|refúgio
escapar|evadir
escaparate|mostrador|mostruário|vitrina
escapatória|evasão|evasiva|fuga|subterfúgio|tergiversação
escapulir|esgueirar|fugir
escarafunchar|esgaravatar|esgravatar|procurar|remexer
escarificar|sarjar
escarnecedor|motejador|zombador|zombeteiro
escárnio|trote|vaia
escarrar|expectorar|expelir
escassear|faltar|rarear|rarefazer
esclarecimento|explicação|justificação
escoadouro|sarja|sarjeta
esconjurador|exorcista
esconjurar|esconjuro|imprecação|maldição|praga
escravo|servo
escrever|grafar|ortografar|redigir
escriba|escrivão
escritor|jornalista|noticiarista|plumitivo|redactor|repórter
escultor|estatuário
escultura|estátua
escuma|espuma
escurecer|negrejar|sombrear
escurecimento|obscurecimento|obumbração|ofuscação|ofuscamento
escuridade|escuridão|negridão|negror|negrura|pretidão
escuridão|negrume|trevas
esdrúxulo|proparoxítono
esfaimado|esfomeado|famélico|faminto|lazarento
esfericidade|imediação|propinquidade|proximidade|redondeza|vizinhança
esforçado|valoroso|virtuoso
esgalho|folha|penca
esgrimidor|esgrimista|espadachim
esguelha|través
esmagar|esmigalhar
esmolar|mendigar|pedir|pirangar
esmurraçar|esmurrar|socar|sopapear|soquear
espaçado|intervalado
espada|gládio|punhal
espádua|ombro
espaldeirada|pranchada
espalhafatoso|mirabolante
espanar|espanejar
espanholismo|hispanismo
espartano|lacedemónio|lacónio
espatifar|espedaçar|estraçalhar|estrafegar
especial|peculiar|privativo|próprio
especialista|perito|profissional|técnico
especializar|especificar|individualizar|individuar|particularizar|pormenorizar|singularizar
especialmente|mormente|principalmente
espectador|testemunha
espelahdo|reflectido|retratado
esperma|sêmen
espesso|grosso
espiar|espionar|espreitar
espigar|grelar
espinhar|ressabiar
espiração|exalação
espiral|lesma
espirar|exalar
espiritual|místico
espiritualismo|psiquismo
espirro|esternutação
espontâneo|instintivo|natural
espórtula|gorjeta|gratificação|molhadura|recompensa|retribuição
esposo|marido
espostejar|esquartejar|retalhar
esputação|salivação
esquadrilha|flotilha
esquecer|olvidar
esquerdino|esquerdo|sestro
esquisitice|mania
esquisito|estrambólico|estranho|excêntrico|invulgar|extravagante|heteróclito|ridículo
essência|núcleo|origem
essencial|forçoso|precípuo|importante|principal|necessário
estabilidade|firmeza|segurança
estacada|paliçada
estampado|gravado|impresso
estampar|exarar|gravar
estampido|estoiro|estouro|estrépito|estrondo|traque|troada
estancar|vedar
estanciar|habitar|morar|residir
estanque|vedado
estatuto|regime|regimento
estável|firme|fixo|inabalável|seguro|sólido
este|leste|levante|nascente|oriente
estenografar|taquigrafar
estenografia|taquigrafia
estenógrafo|taquígrafo
estéril|improdutivo|infecundo|infértil|maninho
estimar|prezar
estimulante|excitante
estímulo|fomento|incentivo|incitação|incitamento
estio|verão
estóico|firme|perseverante|resoluto
estopim|mecha|pavio|rastilho|torcida
estrábico|vesgo|zambaio|zanaga|zarolho
estrado|palco|tablado
estreme|genuíno|puro
estrepitoso|ruidoso
estria|listra|raia|raja
estriado|listrado|sulcado|raiado|rajado
estroinice|estúrdia|excentricidade|extravagância|singularidade
estrondar|estrondear|troar|tronar|trovejar|trovoar
estupor|estuporado
esverdeado|glauco|verdemar
etapa|lanço
eternidade|evo|perpetuidade
eternizado|perpetuado|vinculado
eternizar|imortalizar|perpetuar
ética|moral
etimologísta|etimólogo
eufonia|melopeia|toada
evacuado|excretado|expelido|segregado
evacuar|excretar|segregar
evaporar|evolar
evidenciar|patentear|revelar
evocar|lembrar|recordar|relembrar|remomerar
exacção|exactidão|precisão
exactamente|justamente|precisamente|rigorosamente
exactidão|rigor
exacto|perfeito|rigoroso|preciso
exagero|excesso
exalação|fumo|vapor
exame|examinação|fiscalização|inspecção|revista|vistoria
examinado|investigado|pesquisado|sondado
exceder|ultrapassar
excelência|primazia|superioridade|vantagem
excelente|magnífico|óptimo|supimpa
excepção|exclusão|limitação|restrição
excepcional|extraordinário|fabuloso|fenomenal|sensacional
exceptuado|excluído|expulso
exceptuar|excluir|limitar|marcar|reservar|restringir
exclusivo|individual|restrito
excreção|secreção
excrescência|superfluidade
excursionista|turista
execução|realização
executável|exequível|factível|possível|praticável|realizável
exemplar|réplica
exercer|exercitar|praticar|treinar|trenar
exercício|manobra|tirocínio|treino
exercitado|treinado
exército|tropa
existir|subsistir|viver
êxito|sucesso|triunfo|vitória
expansionismo|imperialismo
expatriar|refugiar
experimentado|ladino|testado|maduro|sazonado|veterano
experimentar|testar
expiação|penitência
expirar|falecer|morrer|perecer|sucumbir
expressão|frase|sentença
expressivo|significativo
expurgar|limpar|mondar
exsudação|suor|transpiração|transudação
extemporâneo|precoce|prematuro|temporão
externo|extrínseco
extorsão|roubo
extraído|tirado
extralegal|ilegal
extraordinariamente|muito|sobremaneira|sobremodo
extraordinário|imprevisto|inacreditável|inesperado|incrível|inopinado|inédito|inimaginável|insólito
extravasar|transbordar|trasbordar
exuberante|superabundante
fabricante|obreiro|operário|trabalhador
facção|partido
facciosismo|partidarismo|proselitismo|sectarismo
faccioso|parcial
fachada|frente|frontaria|frontispício
facundo|loquaz|palavroso|prolixo|verboso
faixa|filete|fita|tira
falador|gárrulo|loquaz|palrador|tagarelador
falatório|locutório|palratório|parlapatório
falda|sopé|vertente
falha|falta|irregularidade|lacuna|lapso|nequice|omissão
falsificado|impuro|viciado
fama|glória|nomeada|notabilidade|renome|reputação
familiaridade|intimidade|privança
fanal|farol
fanhoso|gangoso|roufenho|rouquenho
fantasioso|imaginoso
farináceo|furfuráceo
fármaco|medicamento|remédio
farnel|merenda
farragem|farrão
fartura|repleção|saciedade|saturação
fascículo|tomo
fase|período|tempo|temporada
fasquía|ripa|sarrafo
fatal|inevitável|trágico|infalível|irremissível
fato|indumentária|indumento|roupa|traje|trajo|veste|vestimenta|vestuário
faustoso|luxento|luxuoso|ostentoso
favor|obséquio
favorecer|propiciar|proporcionar
favoritismo|nepotismo
favorito|predilecto
fazenda|herdade|quinta|rancho
fazendeiro|quinteiro
fecundado|fertilizado
fecundador|fecundante|fertilizante
fecundante|fértil|opimo|produtivo|prolífero|prolífico
fecundar|fertilizar
fecundidade|feracidade|fertilidade
fecundo|feraz|fértil|frutuário|produtivo|púbere|úbere
federal|federalista
fedor|odor
feição|guisa|laia|maneira|modo
feijão|feijoeiro
feio|mal-parecido
feiticeiro|mágico|mago
feitiço|mandinga|manipanço
feixe|lio
felpa|penugem
femeeiro|galã|galanteador
fenda|fissura|fresta|fresta|greta|frincha|racha|greta|sulco
fenestra|janela|ventana
fenómeno|maravilha
fereza|ferocidade
ferir|magoar|melindrar
fermentação|levedação
fermentar|levedar
fermento|levedo|levedura
ferramenta|instrumento|utensílio
ferro-velho|tarega
férula|palmatória
fervorosamente|veementemente
festa|sarau
festividade|solenidade
fétido|mefítico|pestilencial
fibra|fibrilha|filamento|ligamento
ficar|permanecer
fictício|figurado|hipotético|imaginário|suposto
fiel|leal
figurado|metafórico|translato|tropológico
figurão|medalhão
fila|fileira
filho|fruto|rebento
filó|tule
fim|término|termo
fímbia|limbo|orla
fímbria|franja
fingimento|simulação
firmamento|fundamento
fiscalizar|inspeccionar|revistar|vistoriar
fitado|mirado|observado|olhado|visto
fitar|mirar|observar|olhar|ver
flato|flatulência|ventosidade
flexível|maleável
flexuoso|sinuoso|torto|tortuoso
fluência|fluidez
focinho|fuça|tromba|venta
fogo|incêndio|lume|queima|queimação|queimada
fogueteiro|pirotécnico
folhagem|ramagem|ramaria
folheto|libelo|livrete|panfleto
fome|inópia|lazeira|míngua|miséria|penúria|rafa
fomentador|promotor
fonte|manadeira|manancial|nascente|natividade
foragido|fugido|homiziado
forense|judicial|judiciario
formador|orientador|preceptor|professor
fornido|robusto
foro|mensalidade|mesada|pensão|renda
forro|revestimento
forte|poderoso|possante|potente
fortuna|riqueza
fossilização|petrificação
fotografia|retrato
fracção|parcela|parte|porção|quinhão
fraccionado|fragmentado|partido|subdividido
fraccionar|fragmentar|partir|subdividir
fraga|fraguedo|penedo|penedia|penha|penhasco|rocha|rochedo
fragmento|mica|miga|migalha|migalho
francês|francesismo|galicismo|gálico|gaulês
franciscano|xabregano
fraquejar|pecar|perverter|prevaricar
fraseado|palavreado
freira|madre
frenesi|fúria|furor|impetuosidade|repelo|violência
frequentatívo|iterativo
frialdade|frigidez
frigidíssimo|regélido
frigir|fritar
frio|indiferente|insensível
friolento|friorento
fritada|fritura
frívolo|fútil|nugativo
frondejante|frondente|frondoso
frontispício|portada|pórtico
frouxidão|lassidão|tepidez|tibieza
frugal|parco|sóbrio
frugalidade|parcimónia|sobriedade|temperança
frugífero|frutífero|frutuoso
fruído|granjeado
frustrado|gorado|goro|malogrado
frutificação|frutificar
fugacidade|rapidez|velocidade
fuligem|imundície|porcaria|sujeira|sujidade
fumaçada|fumaceira|fumarada
fumador|fumante|fumista
funda|fundíbulo
fundação|instalação|instauração
fundente|fusível
fúnebre|funerário|funéreo|lúgubre|lutuoso|sepulcral
funileiro|latoeiro
furto|latrocínio|pilhagem|rapacidade|rapina|rapinagem
futricar|mercadejar|trafegar|traficar
futuro|horizonte|porvir
gado|manada|mancheia|rebanho
gagueira|tartamudez|tatarez
gaguejar|tartamudear|titubear
gaguez|tartamudez
galardão|homenagem|láurea|laurel|prémio
galardoado|premido|recompensado
galinha|penosa
galrar|galrear|papaguear|tagarelar
gandaia|léu|vadiação|vadiagem|vagabundagem
ganhar|lucrar
ganho|lucro|proveito
ganido|uivo|ululado
garantido|guardado|reservado
garantir|prometer
garganta|gasganete|goela|gorgomilos
garimpo|mina
garota|pequena
gatunice|ladroeira|ratonice
gatuno|ladrão|larápio|rapace|rapinante|ratoneiro|vigarista
gaudério|larápio|madraço|ocioso|tunante|vadio|vagabundo
gazeta|jornal|publicação
gemebundo|gemedor
gemer|lamuriar
gemido|lamento|plangor|vagido
generosidade|liberalidade|magnanimidade|munificência|nobreza
genitor|pai|progenitor
geral|universal
gérmen|semente
germinar|grelar
gestação|gravidez|prenhez
gesticulação|mímica
girar|remoinhar|rodopiar
giratório|rotatório
gleba|leiva
globo|mundo|orbe
glossário|vocabulário
glote|goto
glutinoso|gomoso|viscoso
golada|gole|golo|hausto|sorvo|trago
golfar|irromper|jorrar
gorjear|trilar|trinar
gorjeio|trilo|trinado
gosto|paladar|palato|sabor
gota|pinga|pingo
gotejar|pingar
graça|perdão
gradação|transição
grafia|ortografia
granizo|saraiva
granuloso|grumoso
grátis|gratuito
grau|intensidade|proporção
grávida|pejada|prenha|prenhe
gravidade|seriedade|sisudez
gravoso|oneroso
grego|helênico|heleno
grifar|sublinhar
grosseira|malcriada|regateira
grulhar|palrar|parolar|tagarelar|taramelar|tarelar
grunhido|ronco
guarda-sol|sombra
guardar|velar|vigiar|vigilar|zelar
guarnecido|marginado|orlado
guindado|hasteado|içado
guindar|hastear|içar
gulodices|guloseimas
habitador|habitante|inquilino|morador|residente
harmonia|simetria
haver|possuir|ter
haveres|posses|possibilidades
hebdomadário|semanal|semanário
hebraico|hebreu|israelita|judaico|judeu|judio|semita|semítico
hegemonia|predominância|preeminência|preponderância|supremacia
heliose|insolação
helvécio|suíço
herança|legado
herbívoro|vegetariano
hercúleo|seivoso|varonil|vigoroso|viripotente
herege|herético
heroicidade|heroísmo
hesitação|indecisão|indeterminação|irresolução|titubeação|vacilação
hesitante|indeciso|irresoluto|trémulo
hévea|seringueira
hexagonal|sextavado
hibernal|hiemal|invernal
hibernar|invernar
hidrângea|hortênsia
hidroavião|hidroplano
hierarquia|jerarquia
higiénico|salutar|saudável
higienização|limpeza|saneamento
histeria|histerismo
hitlerismo|nazismo
holocausto|imolação|sacrifício
homem|varão
homenzarrão|latagão
horizontal|nivelado
horrível|horroroso
horta|horto|quintal
hortelão|horticultor
hospício|sanatório
humanar|humanizar
humilhante|vexante|vexativo|vexatório
idealista|ideologista|ideólogo
ideia|teoria
idioma|linguagem
idiotice|imbecilidade|inépcia
igualdade|paridade
igualmente|também
ilegal|ilícito|proibido
ileso|incólume
ilha|ilhéu|ilhota
ilharga|quadril
ilimitado|inacabável|indeterminado|infindo|interminável|intérmino
ilusionismo|prestidigitação
ilusionista|prestidigitador|prestímano
ilusório|imaginário|inexistente|irreal|quimérico|umbrático
imaculado|impoluto
imaterial|impalpável|incorpóreo|intáctil|intangível|intocável
imediato|inesperado|inopino|repentino|subitâneo|súbito
imensurável|incomensurável|incontável|infinito|inumerável|inúmero
imergido|submarino|submergido
imersão|mergulho|submersão
imitador|plagiador|plagiário
imodesto|petulante
imoral|impudico|obsceno
imorredoiro|imorredouro|imortal|imperecível
imoto|imóvel|parado|quedo|quieto
impaludismo|malária|maleita|paludismo|sezão|sezonismo
ímpar|incomparável|nunes|sempar|singular|único
imparcial|justo|recto
impassível|imperturbável|inalterável|incorruptível
impeditivo|proibitivo|proibitório
impensado|inadvertido|inconsiderado|irreflectido
imperícia|inabilidade|inaptidão|incapacidade|incompetência|inexperiência
império|poderio|predomínio
impertinente|importuno
impérvio|intransitável|ínvio
impetrante|requerente|suplicante|súplice
impiedade|inclemência
implorar|obsecrar|pedir|postular|rogar|suplicar
implume|nuelo|recém-nascido
importância|influência|preço|relevância|prestígio|valia|valimento|valor
impossibilitado|inábil|inapto|incapaz|inepto
impotência|insuficiência
impreciso|indefinido|indefinível|indeterminado
imprensa|prelo|prensa
imprensar|imprimir
impressão|sensação|sentimento
impressionabilidade|sensibilidade|susceptibilidade
impressionável|sensível
impreterível|improrrogável|inadiável|urgente
impróprio|inadequado|incoveniente|inoportuno
improvisados|repentista
impudicícia|impureza
imunidade|isenção
imutabilidade|inalterabilidade|invariabilidade
imutável|inalterável
inacabado|incompleto|truncado
inacção|inactividade|inércia
inaceitável|inadmissível|incabível|intolerável
inactivo|inerte|paralisado
inarrável|indescritível|indizível|inefável|inenarrável
inaugural|incipiente|inicial|principiante
incensador|incensário|turíbulo
inchar|intumescer|tumefazer|turgescer
inclinado|predisposto|propenso
incombinável|incompatível|inconciliável|incongruente
incómodo|indisposição|molesto|mal-estar
incomplacência|intolerância|intransigência
incompreensível|indecifrável|inexplicável|ininteligível|obscuro
incondicionado|o absoluto|o infinito
inconquistável|inexpugnável|insuperável|invencível
inconstante|instável|mutável|variante|variável|versátil|volúvel
incontestável|indiscutível|inegável|irrecusável|irrefragrável|irrefutável
inconveniência|senão
incorruptível|incorrupto|insubornável|integro
incurável|insanável|irremediável
incursão|invasão|irrupção
indecência|obscenidade
indefectibilidade|infalibilidade
index|índice
indianismo|indianista
indício|sinal|vestígio
indignado|revoltado
indignar|revoltar
indiscriminável|indistinguível
indisfarçável|indissimulável
indivíduo|quidam|sujeito|tipo
indolência|moleza|preguiça|torpor
indolente|mandrião|preguiçoso|tardo
induzimento|instigação|persuasão
inelutável|irresistível|irrespondível|irretorquível
inesgotável|inexaurível
inesquecível|inolvidável|memorável|rememorável
infância|puerícia
infeccionar|infectar
inferior|subalterno|subordinado
influir|infundir|inspirar
influxo|inspiração
ingrato|mal-agradecido
ingrediente|substância
inibição|interdição|proibição|veto
inimizar|malquistar
iníquo|injusto
injecção|seringação|seringadela
injuriado|insultado|invectivado|maltratado|ofendido|prejudicado|ultrajado
injuriador|insultador|insultante|ultrajante
inocente|puro|simples|singelo
inócuo|inofensivo
inquérito|interrogatório|questionário|sindicância
inquinado|poluído|poluto
inquisição|interrogação|pergunta|quesito|questão
inscrição|letreiro|matrícula
insegurança|instabilidade
insinuação|sugestão
insinuado|proposto|sugerido
insinuador|insuflador
insípido|insosso|insulso
insistente|persistente
insistir|martelar|obstinar|teimar
insociável|intratável|misantropo
instantâneo|momentâneo
instante|momento
instrumentar|orquestrar
insular|isolar
insuprível|irrecuperável|irremediável|irreparável
intacto|inviolado|virgem
inteireza|plenitude
intelectivo|intelectual
inteligência|lucidez|perceptibilidade
intencional|premeditado|propositado
intencionalmente|propositadamente
intensivo|intenso
intentar|pretender
intercalação|interpolação
intercessor|intermediário|mediador|medianeiro|mediatário
interditar|obstar|proibir
interior|interno
interpelar|interromper
interpretação|tradução|versão
intérprete|tradutor
interstício|intervalo|poro
intervalo|pausa
intervenção|mediação
intestino|tripa
intimação|notificação
intransferível|intransmissível
intricado|problemático
intruso|usurpador
intuição|percepção
inválido|irrito|nulo|vão
invertido|prepóstero|virado|voltado
irmã|mana
irredimível|irresgatável
irredutível|irreduzível
irreflexão|leviandade
irrigação|rega|regadura
irroração|orvalhada
isolado|só|solitário
itinerário|trajecto
jaguar|onça
jamais|não|nunca
japonês|nipónico
jau|javanês
jazigo|mausoléu|sepulcro|sepultura|tumba|túmulo
jeovismo|judaísmo
jeremiada|lamentação|lamúria|queixa
jorna|jornal|ordenado|paga|remuneração|salário|vencimento
jornadear|peregrinar|viajar
jornaleco|pasquim
jorro|vómito
judicatura|tribunal
judicioso|sentencioso
jugo|opressão|tirania
juízo|pensamento|raciocínio
jura|juramento|promessa|voto
juro|lucro|renda|rendimento
justapor|sobrepor
lã|pelo|velo
labutar|obrar|operar|trabalhar|trabucar
laçada|laço|nó
lacrimante|lacrimoso|plangitivo
lactar|mamar
lácteo|lactescente|leitoso
lacuna|vácuo|vazio
ladainha|litania
ladear|margear|marginar|orlar
ladino|latino
ladrado|ladrido|ladro|latido
laico|leigo|secular
lama|limo|lodo|vasa
lamentável|lamentoso|lastimoso|plangente
lanar|lanígero
languinhento|pegadiço|pegajoso|peganhento
lanoso|lanudo|lanzudo|lãzudo
lanugem|pilosidade
largueza|largura
lavabo|lavatório|pia
lazarento|lázaro|leproso|morfeico|morfético
lazareto|leprosário
ledor|leitor
legal|legítimo|lícito|lítico|permitido
legalidade|legitimidade|validade
lembrança|memorandum|presente|memorial|recordação
lenda|mito
lenhador|rachador
lentura|orvalho|relento
letal|mortal|mortífero
letalidade|mortalidade|mortandade|obituário
leve|ligeiro
libertamento|livramento|resgate
libertinagem|meretrício|prostituição
lição|prelecção
licitador|licitante
lidar|mourejar
ligação|relação
ligar|vincular
limitado|restringido
linguareiro|tagarela
linha|risca|risco|traço
liturgia|rito|ritual
lívido|lúrido|pálido
lôbrego|lúgubre|tétrico|triste
loca|lora|lorga|lura|toca
local|lugar|sítio
lomba|lombada
lombriga|sanguessuga
longitude|lonjura
loquacidade|tagarelice|tarelice|verbosidade
lorpice|palurdice|parlemice|parvoíce|patetice
loto|quino
lubrificado|oleado|untado
lúdico|lúdrico
lusitano|luso|português
lustro|quinquênio
macho|masculino|másculo|viril
maciez|macieza
mácula|mancha|nódoa
madeixa|marrafa|melena|trança
madracear|mandriar|vadiar|vagabundar
madre|matriz|útero
madrugar|matinar
madurez|madureza|maturação|maturidade|sazonamento
magote|multidão
malandragem|malandrice
maldade|malícia|malvadeza
maldizente|maledicente|malético|praguento
maldoso|maléfico|malévolo|malfazejo|malicioso|malvado|mau|perverso|pravo|ruim
malta|mamparra|súcia
maluqueira|maluquice|pancada
mama|peito|pomo|seio|úbere
manchado|sujo|tinto
mancheia|punhado
mandato|procuração
mândria|mandriice|preguiça
maneiro|manejável|portátil|versátil
manejar|manusear|menear|saracotear
manifestação|revelação|sintoma
manto|véu
maometano|muçulmano|muslim
mapa|planta
marconigrama|radiograma
marinheiro|marujo|nauta|navegador|navegante
marinho|marítimo|oceânico|pelágico
maroteira|patifaria
mártir|vítima
mascar|mastigar|ruminar
massa|tamanho|volume
masturbação|onanismo
matagal|mato|sarça|silvado|silvedo
matéria|material
matinal|matutino
matreiro|sorrateiro
maxila|queixada
máximo|sumo|supremo
mazorral|mazorreiro
medição|mensuração
meditabundo|meditativo|melancólico|pensativo|reflexivo
meditação|reflexão
medo|pânico|pavor|susto|temor|terror
medrar|prosperar
melífluo|meloso
melindrado|ressabiado
melindre|ressentimento
mendicância|mendicidade|miséria|necessidade|pobreza
mendicante|mendigo|pedinte|pobre
mendicidade|pedintaria
menina|moça|moçoila|rapariga
menstruação|mênstruo
mentira|moca|pataratice|patranha|peta
mento|queixo
meretriz|perdida|prostituta|rameira
mergulhar|reprofundar|submergir
mérito|préstimo|valor
mescla|mistura|promiscuidade
mesclado|misturado|variegado
meseta|planalto
mesquinharia|mesquinhice
mestiça|mulatinha
mestre|rabi|rabino
metáfrase|paráfrase
metagrama|metaplasmo
metamorfose|mudança|transformação|mutação|transformação|transmutação
meticuloso|minusioso|pormenorizado
metrificador|versejador
mexerufada|mistela|mixórdia|moxinifada
mictar|urinar
migração|transmigração
migrador|transmigrador
migrar|transmigrar
mil|milénio
mínio|zarcão
minúcia|minuciosidade|minudência
minutar|rascunhar
mioleira|miolos
mirada|olhadela|olhadura
miradouro|mirante|observatório
mirante|mirone
mirrado|murcho
misantropia|taciturnideda
missionário|pregador|propagandista
mitologista|mitólogo
moagem|moedura
mobilar|trastejar
moçada|rapaziada
moda|tendência|voga
modelação|modelagem
modelo|padrão|protótipo
moderador|moderativo
modernice|modernismo|neologismo
modéstia|naturalidade|simplicidade|singeleza
modilho|modinha|música
moenda|moinho
mole|tenro
moleirão|molengão|pastelão
monarca|régio|rei
monarquia|reino
monólogo|solilóquio
monstruoso|teratológico
montanha|serra
montanhês|serrano
moreno|mulato|trigueiro
morgue|necrotério
mortalha|sudário
mostras|sinais|vestígios
motora|motriz
mouco|surdo
movediço|móvel|movente
móvel|traste
mover|movimentar
mu|muar|mula|mulo
multicolor|multicor|policromo
multidão|plebe|povaléu|povaréu|poviléu|povo|turba
multifário|multiforme|multímodo
multilingue|poliglota
multíplice|múltiplo
mundano|terreno
mungir|ordenhar
muralha|muramento|muro|paredão
murmurar|suspirar|sussurrar
murro|soco|sopapo
musculado|musculoso|nervudo
musical|músico
mútuo|reciprocamente
nação|nação|país|pátria|região
nacional|pátrio|vernáculo
nacionalista|patriótico
nacionalização|naturalização
nacionalizar|naturalizar
nada|zero
nado|nascido|nato
narigão|narigudo
nascimento|promanação
natura|natureza
natural|originário|oriundo|procedente|proveniente
náutica|navegação
navegar|velejar
necessidade|premência|urgência
negado|recusado|refutado|rejeitado
negrada|negralhada|negraria
negro|preto
nervo|nervura|tendão
neuralgia|nevralgia
neurite|nevríte
neuropatia|neurose|nevropatia
neurótico|nevrótico
neutral|neutro
nitrido|relincho|rincho
nitrir|relinchar|rinchar
nitro|salitre
nobre|sublime|superior|transcendente
noiva|prometida
noivo|nubente
normalizar|regularizar
norte|setentrião
notário|tabelião
nova|novidade
novela|romance
obediente|submisso
objectar|regardir|replicar|retorquir|retrucar|revidar
objecto|peça
oblação|oblata|oferenda|ofertório
oblatar|oferendar
obliquidade|soslaio|viés
obnóxio|servil
obsecração|pedido|petição|rogo|súplica
obsequiador|prestadio|prestativo|prestável|prestimoso|serviçal
observação|reparo
obsessão|preocupação
obsessor|obsidente
obstáculo|travanca|tropeço
obumbrar|toldar|turbar
ocidente|oeste|poente
ócio|ociosidade|repouso
oco|vazio
oficial|solene
oficio|profissão
olmeiro|olmo|ulmeiro
omissão|preterição
omitido|postergado
onda|vaga
ondeado|ondulado|ondulante
ondear|ondular
oneroso|pesado
opalescente|opalino
opressão|vexação|vexame
oração|prece|reza
oral|verbal|vocal
orar|rezar
oratória|retórica
orbe|universo
órbita|trajectória
ordenação|ordenamento
orelha|ouvido
organismo|organização
ornear|ornejar|rebusnar|zurrar
orneio|ornejo|zurro
ortoépia|prosódia
orvalhado|róscido
otomano|turco
outorgador|outorgante
ovado|oval
pachorra|paciência
padaria|panificação
padecente|penado
padrinho|paraninfo
pagar|remunerar
painel|pintura|quadro|tela
palanque|tribuna|varanda
palavra|termo|vocábulo
palavreado|palavrório|parlanda|parlenga|parouvela
palidez|palor
palmear|palmilhar|trilhar
palpite|presciência|pressentimento|previsão
pano|tecido
panorama|quadro
paparrotar|paparrotear
papeira|parotidite|trasorelho
parada|paragem
paraneia|paranóia
parapeito|peitoril
parasita|sevandija|verme
parecença|semelhança|símile|similitude
parte|secção|segmento
particular|pessoal|privado
passadeira|zebra
passadiço|passadoiro|passagem
passado|pretérito
pátio|recinto
patrulha|ronda|sentinela|vigia
patrulhar|rondar|vigiar
pauta|tarifa|taxa
paz|silêncio|sossego|tranquilidade
peanha|pedestal|plinto|supedâneo
pecado|perversão|vício
pecador|pecante
pecúlio|pegulho
pegajoso|peganhento
peia|trava
peita|suborno
pelanca|pelanga
pelejar|pugnar
pelotiqueiro|saltimbanco
pendente|pendurado|pênsil|suspenso
peneira|tamis
penetrante|perspicaz|subtil|sutil
perca|perda|perdida
percurso|trajectória
peregrinação|romagem|romaria|viagem
peregrinador|peregrinante|peregrino
perfeição|sublimidade
perigo|risco|transe
permeável|poroso
permutável|trocável
pernóstico|pronóstico
perplexão|perplexidade
persa|persiano|pérsico|pérsio
peruano|peruviano
pesar|tarar
pestanear|pestanejar|piscar
piado|pio
pião|piorra|pitorra
picar|pungir
pictórico|pinturesco|pitoresco
pilha|rima
pinchar|pular|saltar
pinhal|pinheiral
pinheiro|pinho
pintainho|pintinho
pirilampo|vagalume
pistola|revólver
pitão|píton
pitonisa|profetisa|sibila
plano|projecto
planta|vegetal
plantas|vegetação|vegetais|vegetalidade
pleonasmo|redundância|superfluidade
pletora|superabundância
plica|prega|refego
pluviómetro|udómetro
poesia|trova|verso
poetar|poetizar|rimar|versar|versejar
poitar|poutar
politicagem|politicalha|politiquice
polvilhado|pulverizado
polvilho|tapioca
porcino|porco|suíno
portilha|seteira
porventura|possivelmente|quiçá|talvez
pospasto|sobremesa
possível|provável|verosímil
posterior|ulterior
potentado|soberano
praça|rossio|terreiro
preambular|prefacial|proemial
preâmbulo|prefácio|prelúdio|pródromo|proémio|prólogo
precatório|rogatório
precaução|prevenção|sobreaviso
precioso|valedoiro|valedouro|valioso
predeterminar|predispor|preestabelecer
prédica|pregação|sermão
predição|vaticinação
predilecção|preferência
predito|profetizado|vaticinado
predominante|preponderante
predomínio|soberania
prefaciar|prefaciar|proemiar
preferido|preposto
preito|vassalagem
preliminar|preparatório|prévio
preparado|prestes|pronto
preparativo|preparatório
prerrogativa|privilégio|regalia
prescrição|receita|récipe
preservativo|preventivo
preso|recluso
préstimo|serventia|utilidade|vantagem
pretendido|solicitado
primário|primitivo|primordial
probabilidade|verosimilhança|verosimilhança
procedência|proveniência
produto|resultado
profanador|sacrílego
profanar|violar
profano|secular|temporal
profeta|vate|vaticinador|vidente
prometedor|promissor|promitente
promulgar|publicar
pronúncia|sotaque
proposição|teorema
protestar|reclamar|reivindicar
pustulento|pustuloso
putativo|reputado
puxar|retirar|retrair
quadrado|quadrângulo|quadrilátero|quadro
queimo|queimor
rabanada|rajada
radiodifusor|radioemissor
radiofusão|radiograma|radiotelegrama
raio|relâmpago
rama|ramada|ramalhete|ramalho|ramo
ramado|ramalhoso|ramoso|ramudo
ramalhete|ramilhete
rangedor|rangente
ranger|ringir
ranheta|ranho
raro|vasqueiro
rasteiro|rastejador|rastejante|réptil
rata|ratazana|rato
ratar|roer
reabilitação|reparação|restauração
readquirir|reaver|retomar
realidade|veras|verdade
reanimador|restaurador|vivificador|vivificante
reaparecer|renascer|ressurgir|ressuscitar|reviver
reaparição|renascença|renascimento
rebrilhar|refulgir|relumbrar|reluzir
receado|temido
recear|temer
receptáculo|recipiente|reservatório|vasilha
recobramento|recobro|reconquista|recuperação
recolhido|retraído
recomeçar|reencetar|reiniciar
recompor|reconstituir
reconstituição|remontagem
reconvir|recriminar
recrescimento|recrudescência|recrudescimento
recuperado|renovado|restaurado
recuperar|restabelecer|restaurar
recurvado|recurvo
redemoinho|sorvedoiro|sorvedouro|torvelinho|turbilhão|voragem|vórtice
redenção|resgate|salvação|salvamento
redizer|reiterar|repetir
redobrado|reduplicado
redondo|rotundo
redor|volta
reduplicação|repetição
reeditar|reimprimir|republicar
reestruturação|reforma|regeneração|renovação|reorganização|restruturação
reestruturar|reformar|regenerar|renovar|reorganizar|restruturar
refeição|repasto
refestelado|repimpado
refestelar|repimpar
reflexo|revérbero
reforçar|substanciar
refractar|refranger
refutar|rejeitar
regressão|retorno|retrocesso
regressar|retornar|revir|tornar|voltar
regressivo|retroactivo|retrocessivo
regresso|retorno|revinda|volta
regurgitar|vomitar
reincidente|relapso|vezeiro
reiterado|repetido
rejeição|repudiação
relaxação|relaxamento
remanescer|restar|sobejar|sobrar
remar|vogar
remediável|reparável
remissível|resgatável
renúncia|repúdio
repartição|secretaria
representar|simbolizar
repressivo|repressor|reprimidor
reserva|suplente
resfolegar|resfolgar
resolução|solução
resolvível|solucionável|solúvel
respeitável|venerando|venerável
respeito|reverência|saudação
respingar|salpicar
ressalva|salvaguarda
ressonância|sonância
ressonante|retumbante
ressudado|ressumado|suado|transpirado
ressudar|ressumar|suar|transpirar|transudar
restos|sobras
resumir|reunir|somar
retinir|tilintar
retrotrair|retroverter
reverenciado|venerado
reverso|revirado
reverter|virar|volver
revogatório|rogativo
rojão|rojo
rosal|roseiral
roupagem|rouparia|roupas|trajes|vestes
rubor|vermelhão|vermelhidão
ruído|rumor|soído|sonido
ruína|ruinoso
rural|rústico
sabático|sabatino
saburrento|saburroso
sadio|salubre
sair|transpor|trespassar
salgado|salso
saliva|seiva
salvante|tirante
sanguinário|sevo
santão|santarrão
sebe|vedação
secção|troço
seco|sedento|sequioso
segredo|sigilo
seguidilha|toada|xácara
seiva|suco
semântica|semiologia
senso|siso|tino
serenata|tocata
serradura|serragem
servilismo|subserviência
sigla|sigla
signatário|subscritor
significar|valer
silabar|soletrar
silencioso|sombrio|soturno|taciturno|tristonho
singular|um|único|uno
sinuosidade|tortuosidade
soar|tanger|toar
sobpor|sotopor|subpor
sobrancelha|sobrecenho|sobrolho|supercílio
sobre-humano|sobrenatural|transcendente
sobrepujar|superar|suplantar|ultrapassar
sofrer|suportar|tolerar
solda|soldadura|soldagem
solvência|solvibilidade
sovina|treteiro|velhaco|zaino
suadouro|sudorífico
subalimentação|subnutrição
submeter|subordinar|sujeitar
subsídio|subvenção
substancial|sucoso|suculento|sumarento|sumoso
sufrágio|votação
sulino|sulista
suplício|tortura
supracitado|supradito|supramencionado
tabela|tábua
tabique|tapume
tecedeira|urdideira
tecedor|tecelão|urdidor
tecto|telhado
têmpera|temperatura
tender|visar
teor|texto
terapêutica|terapia
tergémino|trigémio|tríplice
terra|terreno
testador|testante
testamental|testamentário
tinir|zoar|zumbir|zunir
tiritante|trémulo
tiroteio|troada
tísico|tuberculoso
tombo|trambolhão
tosa|tosquia
tosar|tosquiar
total|totalidade
touca|trunfa|turbante
trado|verruma
traduzir|transcrever|trasladar
tráfego|tráfico
tranqueira|trincheira
transcorvo|transcurvo
transeunte|viajante|viajor
translação|trasladação
transluzir|transparecer|transudar
trasmontano|ultramontano
trauma|traumatismo
treinagem|treinamento|treno
tremelear|tremelicar|tremer
tríade|trilogia|trindade
triunfador|triunfante|vencedor|vitorioso
tropeçar|tropicar
trôpego|zopo
turno|vez
unido|unificado|uno
unissonante|uníssono
vacação|vacância|vacatura|vaga|vagante|vagatura|vagatura
valado|vedro
variabilidade|versatilidade
variante|versão
velhacada|velhacagem|velhacaria
velhice|vetustez
velocidrómo|velódremo
ventania|vento
veracidade|verdade
verde|verdejante|virente
verdor|viço|viçoso
vibrador|vibrante|vibratório
vilanagem|vilania
vileza|vitupério
virada|viradela
visita|visitante
vivacidade|viveza
voador|voante|volátil
volúpia|voluptuosidade
zoada|zoeira|zumbido|zunido
zoologista|zoólogo
